Date,Central,East,North,NorthEast,South,West,Total
01/01/2011,21,12,5,24,4,7,73
01/02/2011,9,6,7,22,11,4,59
01/03/2011,11,4,3,18,6,2,44
01/04/2011,7,0,6,16,3,4,36
01/05/2011,20,3,4,17,6,4,54
01/06/2011,12,3,3,16,7,4,45
01/07/2011,11,6,5,18,4,7,51
01/08/2011,13,6,1,13,4,1,38
01/09/2011,15,9,2,14,4,1,45
01/10/2011,12,6,4,9,10,0,41
01/11/2011,13,7,4,20,4,4,52
01/12/2011,8,3,2,6,3,1,23
01/13/2011,9,2,4,11,5,2,33
01/14/2011,8,4,1,13,2,1,29
01/15/2011,11,8,7,17,6,1,50
01/16/2011,10,10,5,10,7,2,44
01/17/2011,11,4,4,18,8,2,47
01/18/2011,8,8,6,14,7,1,44
01/19/2011,16,7,6,6,11,4,50
01/20/2011,14,0,4,10,3,2,33
01/21/2011,4,4,4,18,5,0,35
01/22/2011,13,6,6,11,8,2,46
01/23/2011,12,8,3,12,6,3,44
01/24/2011,8,4,4,10,4,0,30
01/25/2011,9,4,0,16,4,0,33
01/26/2011,12,5,6,12,8,0,43
01/27/2011,13,5,3,8,7,3,39
01/28/2011,19,6,2,10,5,3,45
01/29/2011,14,7,5,15,11,2,54
01/30/2011,12,10,19,14,5,1,61
01/31/2011,15,3,13,13,8,4,56
02/01/2011,10,7,6,17,8,1,49
02/02/2011,17,7,3,23,9,3,62
02/03/2011,13,5,10,19,7,2,56
02/04/2011,17,6,4,15,2,1,45
02/05/2011,11,3,12,19,11,1,57
02/06/2011,13,6,5,15,7,0,46
02/07/2011,9,6,4,5,6,2,32
02/08/2011,10,5,7,13,5,2,42
02/09/2011,6,8,4,19,6,5,48
02/10/2011,10,3,5,18,6,1,43
02/11/2011,6,4,6,7,5,0,28
02/12/2011,17,6,5,12,9,2,51
02/13/2011,20,7,6,20,9,0,62
02/14/2011,8,11,7,6,5,2,39
02/15/2011,10,7,7,10,10,5,49
02/16/2011,12,2,5,13,12,6,50
02/17/2011,6,6,4,11,6,6,39
02/18/2011,5,6,6,14,10,1,42
02/19/2011,18,6,4,11,1,7,47
02/20/2011,12,5,2,12,8,5,44
02/21/2011,11,6,13,10,14,4,58
02/22/2011,6,2,8,9,6,0,31
02/23/2011,7,9,7,10,12,0,45
02/24/2011,15,6,4,8,7,6,46
02/25/2011,11,2,3,11,7,2,36
02/26/2011,11,2,9,11,12,3,48
02/27/2011,13,5,5,9,6,2,40
02/28/2011,9,6,5,10,9,1,40
03/01/2011,19,5,10,14,9,1,58
03/02/2011,17,8,1,18,10,5,59
03/03/2011,15,2,1,5,6,3,32
03/04/2011,9,6,5,16,8,2,46
03/05/2011,6,4,2,19,8,2,41
03/06/2011,6,5,6,20,7,7,51
03/07/2011,21,10,4,11,8,5,59
03/08/2011,11,3,6,14,6,3,43
03/09/2011,8,5,5,11,6,1,36
03/10/2011,12,6,3,14,4,3,42
03/11/2011,15,4,6,12,11,0,48
03/12/2011,4,11,3,14,7,5,44
03/13/2011,9,9,7,12,9,1,47
03/14/2011,13,5,10,11,7,2,48
03/15/2011,21,4,8,14,9,5,61
03/16/2011,7,3,2,13,9,3,37
03/17/2011,6,3,12,8,13,1,43
03/18/2011,10,6,6,21,8,2,53
03/19/2011,15,6,3,16,5,0,45
03/20/2011,16,10,2,12,7,4,51
03/21/2011,13,3,5,14,11,4,50
03/22/2011,15,2,3,16,6,2,44
03/23/2011,6,5,4,11,4,2,32
03/24/2011,12,7,5,9,5,2,40
03/25/2011,10,9,1,10,5,1,36
03/26/2011,6,3,4,11,3,2,29
03/27/2011,16,8,4,14,4,3,49
03/28/2011,9,3,3,6,9,2,32
03/29/2011,4,2,2,3,7,1,19
03/30/2011,11,2,2,7,2,2,26
03/31/2011,11,8,4,9,6,1,39
04/01/2011,14,4,5,12,4,0,39
04/02/2011,11,9,4,11,6,1,42
04/03/2011,11,3,6,8,5,4,37
04/04/2011,14,2,7,11,5,3,42
04/05/2011,8,1,6,13,4,3,35
04/06/2011,13,1,5,9,6,2,36
04/07/2011,8,3,7,19,10,1,48
04/08/2011,8,6,0,6,6,4,30
04/09/2011,11,4,5,17,6,3,46
04/10/2011,15,5,6,23,11,2,62
04/11/2011,14,5,7,18,7,5,56
04/12/2011,7,7,5,13,6,1,39
04/13/2011,18,7,11,16,13,1,66
04/14/2011,17,6,5,9,7,1,45
04/15/2011,18,0,8,20,4,0,50
04/16/2011,17,1,2,23,4,2,49
04/17/2011,11,5,3,9,5,2,35
04/18/2011,14,5,4,7,3,2,35
04/19/2011,8,4,0,9,9,0,30
04/20/2011,11,7,3,10,5,5,41
04/21/2011,8,4,2,13,4,3,34
04/22/2011,12,5,3,8,5,1,34
04/23/2011,15,4,7,13,6,1,46
04/24/2011,15,3,4,5,7,3,37
04/25/2011,11,6,6,10,5,4,42
04/26/2011,14,1,3,4,2,1,25
04/27/2011,7,7,1,11,5,1,32
04/28/2011,7,4,3,12,2,2,30
04/29/2011,8,3,4,14,5,3,37
04/30/2011,6,7,4,6,11,0,34
05/01/2011,9,7,3,12,4,3,38
05/02/2011,13,8,6,13,3,3,46
05/03/2011,15,4,7,11,15,2,54
05/04/2011,13,1,7,14,7,4,46
05/05/2011,13,5,5,15,6,1,45
05/06/2011,10,7,2,13,9,1,42
05/07/2011,8,4,6,16,3,2,39
05/08/2011,8,8,3,14,8,7,48
05/09/2011,10,9,3,16,5,2,45
05/10/2011,14,1,2,12,5,3,37
05/11/2011,10,5,0,12,10,2,39
05/12/2011,12,1,7,17,7,1,45
05/13/2011,14,4,7,8,8,1,42
05/14/2011,9,4,5,12,9,2,41
05/15/2011,11,6,1,11,7,1,37
05/16/2011,5,4,4,10,5,4,32
05/17/2011,13,6,8,10,2,1,40
05/18/2011,16,4,2,10,4,0,36
05/19/2011,9,4,5,10,6,2,36
05/20/2011,9,6,3,6,6,2,32
05/21/2011,12,3,6,9,8,6,44
05/22/2011,15,9,2,14,11,6,57
05/23/2011,7,5,1,1,8,4,26
05/24/2011,10,3,6,9,7,2,37
05/25/2011,6,1,2,13,8,1,31
05/26/2011,13,4,5,9,6,0,37
05/27/2011,15,1,2,9,9,4,40
05/28/2011,10,8,4,11,6,5,44
05/29/2011,6,6,2,8,10,4,36
05/30/2011,4,6,3,12,3,1,29
05/31/2011,11,5,4,8,6,1,35
06/01/2011,12,13,3,19,6,1,54
06/02/2011,8,6,4,8,3,3,32
06/03/2011,10,6,5,17,6,2,46
06/04/2011,17,3,2,9,6,3,40
06/05/2011,11,7,4,13,4,0,39
06/06/2011,5,5,4,12,9,0,35
06/07/2011,7,1,1,11,4,0,24
06/08/2011,14,4,3,13,12,1,47
06/09/2011,14,3,1,6,4,1,29
06/10/2011,12,2,5,13,12,0,44
06/11/2011,17,5,3,16,8,3,52
06/12/2011,11,9,4,9,6,5,44
06/13/2011,9,1,4,10,4,2,30
06/14/2011,9,4,4,9,9,1,36
06/15/2011,6,3,4,11,7,2,33
06/16/2011,19,6,3,14,10,2,54
06/17/2011,6,1,4,11,11,2,35
06/18/2011,7,1,6,25,9,3,51
06/19/2011,12,4,4,16,5,1,42
06/20/2011,9,3,2,4,5,3,26
06/21/2011,6,3,4,8,12,1,34
06/22/2011,5,3,4,12,5,2,31
06/23/2011,11,3,3,10,8,3,38
06/24/2011,10,3,2,11,7,1,34
06/25/2011,8,7,4,9,6,3,37
06/26/2011,10,5,2,5,3,2,27
06/27/2011,8,2,4,13,9,1,37
06/28/2011,12,6,8,6,6,3,41
06/29/2011,10,5,3,12,4,1,35
06/30/2011,5,7,3,17,9,3,44
07/01/2011,10,3,6,20,6,6,51
07/02/2011,14,7,5,16,8,2,52
07/03/2011,7,3,0,14,9,1,34
07/04/2011,6,4,3,10,4,2,29
07/05/2011,9,2,9,17,7,2,46
07/06/2011,15,6,1,13,7,3,45
07/07/2011,13,3,4,19,8,2,49
07/08/2011,10,2,2,16,11,0,41
07/09/2011,13,7,4,12,4,1,41
07/10/2011,15,8,4,10,8,0,45
07/11/2011,12,3,4,12,9,2,42
07/12/2011,9,5,2,13,12,1,42
07/13/2011,10,7,5,12,7,3,44
07/14/2011,5,2,4,9,4,1,25
07/15/2011,19,5,4,13,6,3,50
07/16/2011,9,7,2,5,6,0,29
07/17/2011,6,5,3,6,4,2,26
07/18/2011,6,3,4,4,11,0,28
07/19/2011,8,4,3,7,9,0,31
07/20/2011,3,1,3,10,5,0,22
07/21/2011,5,2,3,5,9,3,27
07/22/2011,8,3,6,11,12,1,41
07/23/2011,5,9,3,7,5,0,29
07/24/2011,11,3,5,13,6,4,42
07/25/2011,7,4,1,5,5,0,22
07/26/2011,4,5,3,6,6,1,25
07/27/2011,6,4,2,10,10,4,36
07/28/2011,7,6,2,11,5,3,34
07/29/2011,10,5,6,9,4,3,37
07/30/2011,12,7,1,9,12,3,44
07/31/2011,10,4,5,9,5,2,35
08/01/2011,8,6,4,10,7,2,37
08/02/2011,5,2,4,5,11,2,29
08/03/2011,10,10,4,19,6,7,56
08/04/2011,16,7,1,5,7,3,39
08/05/2011,11,3,4,6,7,1,32
08/06/2011,7,6,0,11,13,6,43
08/07/2011,9,7,3,4,5,0,28
08/08/2011,12,4,3,6,14,1,40
08/09/2011,10,4,4,7,7,2,34
08/10/2011,12,10,4,6,8,0,40
08/11/2011,6,6,8,6,10,1,37
08/12/2011,13,4,4,14,13,1,49
08/13/2011,9,6,4,11,6,5,41
08/14/2011,11,4,6,7,9,0,37
08/15/2011,9,4,0,7,9,0,29
08/16/2011,9,2,3,5,11,3,33
08/17/2011,9,1,8,10,8,1,37
08/18/2011,8,4,3,6,10,3,34
08/19/2011,7,3,6,4,8,5,33
08/20/2011,12,1,7,11,9,2,42
08/21/2011,7,4,4,6,2,1,24
08/22/2011,12,2,5,6,9,1,35
08/23/2011,11,3,4,8,1,5,32
08/24/2011,12,4,3,9,8,3,39
08/25/2011,10,1,3,7,6,0,27
08/26/2011,6,4,0,21,4,4,39
08/27/2011,9,4,2,12,10,1,38
08/28/2011,11,9,3,6,6,1,36
08/29/2011,12,1,5,10,6,2,36
08/30/2011,14,5,1,4,11,1,36
08/31/2011,13,5,5,9,9,2,43
09/01/2011,7,8,4,10,9,0,38
09/02/2011,7,3,5,11,7,2,35
09/03/2011,7,4,5,9,6,1,32
09/04/2011,17,4,9,12,14,3,59
09/05/2011,11,6,10,6,3,2,38
09/06/2011,10,2,1,5,8,2,28
09/07/2011,9,2,3,8,4,4,30
09/08/2011,14,3,6,8,8,1,40
09/09/2011,7,5,2,5,10,3,32
09/10/2011,8,1,6,14,6,7,42
09/11/2011,5,4,6,10,4,4,33
09/12/2011,7,2,5,7,7,2,30
09/13/2011,12,10,5,10,7,2,46
09/14/2011,9,5,2,6,7,0,29
09/15/2011,15,1,1,7,9,0,33
09/16/2011,11,5,1,4,7,3,31
09/17/2011,9,7,1,12,8,1,38
09/18/2011,14,6,3,14,11,3,51
09/19/2011,11,3,2,7,11,3,37
09/20/2011,11,0,4,8,8,0,31
09/21/2011,9,2,6,8,6,1,32
09/22/2011,7,6,2,7,9,1,32
09/23/2011,9,4,3,7,8,2,33
09/24/2011,12,5,3,7,6,2,35
09/25/2011,10,2,5,6,6,1,30
09/26/2011,12,6,2,6,10,5,41
09/27/2011,5,4,3,3,4,1,20
09/28/2011,7,4,2,5,6,1,25
09/29/2011,11,3,3,8,5,1,31
09/30/2011,8,0,7,13,8,2,38
10/01/2011,15,3,4,6,11,4,43
10/02/2011,8,4,8,10,7,6,43
10/03/2011,8,2,1,8,6,2,27
10/04/2011,9,3,7,7,2,3,31
10/05/2011,8,4,2,3,6,0,23
10/06/2011,8,8,4,14,7,3,44
10/07/2011,8,5,1,7,5,0,26
10/08/2011,7,5,3,12,4,0,31
10/09/2011,14,3,3,8,8,1,37
10/10/2011,2,2,4,9,4,4,25
10/11/2011,10,2,3,16,20,5,56
10/12/2011,6,3,2,12,13,0,36
10/13/2011,9,3,4,7,8,2,33
10/14/2011,17,6,4,10,5,1,43
10/15/2011,8,4,4,9,9,2,36
10/16/2011,7,4,4,18,9,0,42
10/17/2011,10,5,3,11,6,2,37
10/18/2011,7,4,4,7,7,1,30
10/19/2011,4,3,7,13,6,0,33
10/20/2011,6,5,2,13,9,1,36
10/21/2011,9,4,5,13,6,3,40
10/22/2011,5,9,3,14,5,2,38
10/23/2011,14,4,5,7,8,0,38
10/24/2011,8,3,3,10,8,2,34
10/25/2011,16,11,1,19,6,1,54
10/26/2011,6,5,6,6,11,4,38
10/27/2011,12,4,3,17,7,2,45
10/28/2011,7,2,8,15,8,1,41
10/29/2011,10,3,6,14,5,2,40
10/30/2011,13,8,2,15,8,1,47
10/31/2011,8,5,4,17,4,3,41
11/01/2011,15,4,7,10,10,7,53
11/02/2011,11,3,9,12,2,2,39
11/03/2011,10,5,2,21,12,5,55
11/04/2011,9,3,6,16,5,4,43
11/05/2011,6,5,3,23,11,3,51
11/06/2011,13,5,4,15,10,6,53
11/07/2011,10,9,5,14,8,1,47
11/08/2011,13,6,3,8,7,5,42
11/09/2011,14,6,7,10,9,1,47
11/10/2011,11,5,7,15,5,4,47
11/11/2011,20,10,11,16,9,3,69
11/12/2011,10,5,3,15,7,1,41
11/13/2011,8,5,3,10,8,3,37
11/14/2011,7,2,4,8,3,2,26
11/15/2011,13,4,1,15,8,4,45
11/16/2011,8,2,6,15,5,2,38
11/17/2011,9,6,4,6,10,1,36
11/18/2011,11,4,5,15,4,4,43
11/19/2011,7,4,6,12,6,4,39
11/20/2011,14,5,1,12,10,2,44
11/21/2011,15,3,8,17,5,5,53
11/22/2011,7,3,2,11,5,4,32
11/23/2011,9,4,4,9,7,1,34
11/24/2011,10,3,3,13,2,0,31
11/25/2011,15,6,6,15,5,3,50
11/26/2011,10,3,1,19,12,2,47
11/27/2011,15,7,1,10,6,4,43
11/28/2011,9,3,5,17,6,2,42
11/29/2011,3,6,9,13,9,3,43
11/30/2011,7,6,4,13,6,5,41
12/01/2011,17,6,3,18,6,7,57
12/02/2011,12,5,6,9,10,1,43
12/03/2011,15,6,5,16,3,2,47
12/04/2011,10,10,12,11,7,7,57
12/05/2011,9,8,2,16,9,5,49
12/06/2011,9,3,2,14,6,0,34
12/07/2011,11,5,4,14,1,2,37
12/08/2011,14,6,3,20,5,1,49
12/09/2011,18,5,4,17,4,4,52
12/10/2011,8,1,8,12,6,3,38
12/11/2011,15,5,3,17,7,3,50
12/12/2011,13,3,2,8,7,1,34
12/13/2011,7,3,3,12,6,0,31
12/14/2011,13,5,4,7,2,0,31
12/15/2011,4,2,7,10,3,3,29
12/16/2011,9,4,5,10,7,2,37
12/17/2011,9,8,8,14,5,2,46
12/18/2011,15,2,8,13,7,3,48
12/19/2011,11,2,4,12,8,4,41
12/20/2011,13,3,1,18,4,3,42
12/21/2011,5,2,5,9,8,1,30
12/22/2011,10,1,7,8,4,2,32
12/23/2011,5,4,5,9,5,4,32
12/24/2011,16,5,7,11,4,2,45
12/25/2011,10,5,4,23,1,3,46
12/26/2011,7,9,4,9,4,2,35
12/27/2011,7,6,3,15,2,1,34
12/28/2011,10,4,5,14,6,4,43
12/29/2011,18,5,5,21,2,1,52
12/30/2011,10,2,5,9,1,1,28
12/31/2011,2,0,0,0,0,2,4
01/01/2012,34,16,9,24,13,3,99
01/02/2012,11,3,8,14,5,2,43
01/03/2012,5,2,6,15,5,0,33
01/04/2012,13,6,4,7,10,3,43
01/05/2012,6,3,4,12,10,2,37
01/06/2012,10,4,8,11,7,1,41
01/07/2012,8,6,6,11,3,4,38
01/08/2012,10,6,3,7,8,2,36
01/09/2012,11,4,3,11,6,0,35
01/10/2012,11,4,4,15,9,1,44
01/11/2012,14,8,3,17,6,1,49
01/12/2012,5,5,4,18,6,4,42
01/13/2012,8,1,6,15,13,4,47
01/14/2012,11,5,1,11,10,2,40
01/15/2012,14,4,5,9,8,1,41
01/16/2012,14,0,5,11,3,2,35
01/17/2012,8,9,3,16,10,1,47
01/18/2012,6,1,1,12,2,2,24
01/19/2012,10,5,4,10,7,7,43
01/20/2012,11,5,6,11,2,6,41
01/21/2012,10,3,1,21,9,2,46
01/22/2012,17,6,9,14,9,7,62
01/23/2012,7,2,3,12,5,5,34
01/24/2012,18,1,6,12,10,4,51
01/25/2012,12,4,3,6,3,0,28
01/26/2012,6,3,5,10,7,4,35
01/27/2012,11,7,6,7,7,1,39
01/28/2012,6,5,2,18,10,3,44
01/29/2012,20,12,2,10,7,4,55
01/30/2012,6,10,7,8,4,2,37
01/31/2012,8,1,3,15,6,4,37
02/01/2012,6,6,5,13,3,4,37
02/02/2012,18,4,6,9,4,2,43
02/03/2012,17,2,12,18,5,3,57
02/04/2012,11,2,6,6,11,1,37
02/05/2012,10,10,0,13,6,2,41
02/06/2012,11,10,6,9,8,1,45
02/07/2012,10,5,5,11,4,1,36
02/08/2012,8,7,5,6,5,2,33
02/09/2012,20,2,1,21,15,5,64
02/10/2012,11,3,4,18,4,1,41
02/11/2012,12,5,3,14,12,6,52
02/12/2012,14,8,0,11,4,0,37
02/13/2012,14,3,0,14,8,1,40
02/14/2012,10,2,2,11,8,1,34
02/15/2012,5,7,2,28,11,0,53
02/16/2012,13,7,2,10,6,3,41
02/17/2012,9,0,2,13,0,5,29
02/18/2012,9,4,5,6,14,4,42
02/19/2012,10,7,6,9,4,1,37
02/20/2012,11,6,7,11,11,1,47
02/21/2012,11,5,1,10,6,2,35
02/22/2012,7,4,3,14,14,2,44
02/23/2012,12,6,3,12,7,0,40
02/24/2012,11,7,4,9,13,4,48
02/25/2012,22,8,7,12,8,5,62
02/26/2012,14,6,7,15,6,2,50
02/27/2012,10,4,2,15,14,1,46
02/28/2012,11,6,10,11,13,5,56
03/01/2012,17,4,6,9,9,2,47
03/02/2012,16,4,6,19,15,4,64
03/03/2012,9,7,9,17,9,2,53
03/04/2012,20,5,2,18,7,9,61
03/05/2012,13,3,6,12,8,3,45
03/06/2012,10,5,7,19,6,2,49
03/07/2012,17,5,1,16,6,2,47
03/08/2012,14,8,3,17,7,1,50
03/09/2012,11,4,4,20,4,7,50
03/10/2012,14,7,5,13,7,3,49
03/11/2012,11,5,9,6,11,6,48
03/12/2012,12,9,7,13,4,4,49
03/13/2012,10,4,6,11,4,0,35
03/14/2012,11,5,3,15,2,3,39
03/15/2012,9,5,7,17,8,4,50
03/16/2012,14,6,6,8,7,2,43
03/17/2012,12,3,6,13,8,0,42
03/18/2012,16,7,5,12,7,3,50
03/19/2012,12,3,10,13,9,3,50
03/20/2012,13,4,8,10,10,2,47
03/21/2012,11,7,7,14,5,4,48
03/22/2012,11,5,3,18,4,2,43
03/23/2012,12,3,1,11,6,5,38
03/24/2012,18,3,0,15,3,5,44
03/25/2012,17,6,4,12,4,4,47
03/26/2012,8,4,3,9,7,1,32
03/27/2012,11,8,3,7,4,2,35
03/28/2012,11,7,5,11,9,4,47
03/29/2012,8,4,6,4,8,1,31
03/30/2012,7,4,7,13,8,4,43
03/31/2012,18,7,9,10,8,1,53
04/01/2012,8,11,4,13,8,2,46
04/02/2012,18,7,6,11,8,1,51
04/03/2012,12,7,2,12,9,4,46
04/04/2012,13,3,4,19,8,3,50
04/05/2012,14,1,2,10,9,3,39
04/06/2012,9,8,2,12,8,9,48
04/07/2012,12,5,1,17,8,0,43
04/08/2012,16,1,4,16,6,2,45
04/09/2012,10,4,5,12,12,1,44
04/10/2012,7,7,2,14,5,2,37
04/11/2012,16,2,2,13,14,1,48
04/12/2012,17,6,7,19,16,2,67
04/13/2012,15,7,11,23,12,3,71
04/14/2012,19,0,9,23,6,3,60
04/15/2012,18,2,3,12,5,1,41
04/16/2012,10,3,4,7,5,4,33
04/17/2012,11,0,9,5,4,8,37
04/18/2012,11,4,5,15,8,3,46
04/19/2012,7,3,3,12,8,1,34
04/20/2012,8,2,7,7,10,1,35
04/21/2012,7,8,6,12,9,1,43
04/22/2012,27,5,5,9,9,12,67
04/23/2012,14,5,4,14,4,3,44
04/24/2012,12,7,5,12,5,5,46
04/25/2012,4,6,6,16,9,4,45
04/26/2012,6,4,4,7,6,0,27
04/27/2012,11,7,3,11,1,3,36
04/28/2012,10,5,5,7,9,0,36
04/29/2012,9,7,3,6,8,4,37
04/30/2012,12,5,4,8,9,2,40
05/01/2012,8,9,2,12,7,2,40
05/02/2012,10,7,6,13,4,4,44
05/03/2012,7,2,5,16,10,2,42
05/04/2012,15,4,3,10,6,6,44
05/05/2012,12,7,5,19,7,5,55
05/06/2012,8,4,6,9,8,4,39
05/07/2012,10,2,0,12,7,1,32
05/08/2012,10,5,0,11,6,1,33
05/09/2012,5,4,7,12,5,2,35
05/10/2012,8,16,2,9,4,1,40
05/11/2012,11,1,2,13,13,5,45
05/12/2012,13,3,4,5,7,7,39
05/13/2012,10,3,6,10,10,3,42
05/14/2012,7,3,4,11,3,2,30
05/15/2012,10,5,3,11,8,2,39
05/16/2012,10,4,1,8,10,1,34
05/17/2012,10,2,1,14,3,2,32
05/18/2012,9,6,6,9,3,1,34
05/19/2012,13,4,7,8,1,1,34
05/20/2012,11,4,7,9,7,3,41
05/21/2012,5,9,3,10,10,3,40
05/22/2012,8,7,7,8,7,4,41
05/23/2012,13,3,4,7,6,0,33
05/24/2012,4,4,1,9,11,4,33
05/25/2012,19,4,4,13,11,4,55
05/26/2012,13,1,2,10,6,5,37
05/27/2012,13,4,4,15,6,2,44
05/28/2012,10,3,7,12,2,0,34
05/29/2012,8,3,2,6,9,4,32
05/30/2012,8,8,1,8,7,1,33
05/31/2012,7,5,4,7,8,3,34
06/01/2012,12,6,3,11,7,3,42
06/02/2012,8,8,5,5,7,1,34
06/03/2012,12,12,7,11,2,3,47
06/04/2012,8,4,2,7,7,5,33
06/05/2012,11,1,2,10,7,4,35
06/06/2012,3,3,3,12,8,1,30
06/07/2012,10,4,4,10,7,4,39
06/08/2012,12,0,4,10,5,5,36
06/09/2012,12,9,4,13,6,3,47
06/10/2012,17,9,3,8,7,5,49
06/11/2012,6,5,5,11,7,2,36
06/12/2012,8,2,3,10,2,2,27
06/13/2012,8,5,5,8,6,0,32
06/14/2012,12,3,5,8,11,3,42
06/15/2012,13,2,7,13,6,5,46
06/16/2012,12,5,3,9,5,4,38
06/17/2012,12,7,4,8,11,5,47
06/18/2012,11,6,7,9,6,4,43
06/19/2012,9,1,2,8,6,2,28
06/20/2012,12,13,0,10,6,4,45
06/21/2012,9,8,1,10,9,2,39
06/22/2012,8,5,2,14,1,3,33
06/23/2012,13,5,3,13,10,3,47
06/24/2012,5,10,2,12,6,3,38
06/25/2012,11,2,7,10,9,4,43
06/26/2012,5,8,4,4,13,5,39
06/27/2012,9,4,7,5,8,3,36
06/28/2012,9,2,6,11,6,3,37
06/29/2012,7,4,4,9,7,6,37
06/30/2012,11,10,3,14,12,2,52
07/01/2012,13,9,2,11,15,1,51
07/02/2012,12,11,1,10,11,2,47
07/03/2012,10,4,2,8,15,2,41
07/04/2012,6,8,1,14,2,2,33
07/05/2012,11,5,5,11,4,1,37
07/06/2012,8,4,3,7,6,1,29
07/07/2012,7,2,7,7,11,6,40
07/08/2012,11,7,5,13,2,5,43
07/09/2012,6,8,2,11,9,0,36
07/10/2012,9,1,3,9,14,0,36
07/11/2012,4,5,2,12,8,0,31
07/12/2012,7,4,0,11,5,3,30
07/13/2012,14,4,1,16,3,1,39
07/14/2012,7,9,6,15,7,2,46
07/15/2012,7,4,0,6,8,0,25
07/16/2012,11,9,3,9,7,5,44
07/17/2012,13,4,1,12,7,1,38
07/18/2012,5,4,4,19,2,4,38
07/19/2012,12,4,7,15,5,2,45
07/20/2012,6,6,1,12,7,4,36
07/21/2012,6,2,4,19,5,3,39
07/22/2012,15,5,5,10,7,2,44
07/23/2012,16,4,2,11,6,0,39
07/24/2012,5,3,4,19,10,2,43
07/25/2012,7,4,3,17,11,0,42
07/26/2012,4,0,2,12,4,1,23
07/27/2012,1,4,3,7,8,3,26
07/28/2012,14,1,6,13,10,0,44
07/29/2012,10,8,0,11,6,3,38
07/30/2012,10,5,1,12,7,2,37
07/31/2012,21,6,5,13,6,3,54
08/01/2012,5,3,4,12,8,2,34
08/02/2012,8,8,6,16,5,3,46
08/03/2012,8,5,4,7,11,3,38
08/04/2012,3,3,2,7,7,4,26
08/05/2012,8,6,2,7,8,2,33
08/06/2012,11,4,3,9,10,0,37
08/07/2012,11,0,3,11,8,4,37
08/08/2012,6,3,3,12,7,4,35
08/09/2012,11,3,3,10,6,1,34
08/10/2012,7,5,1,7,10,3,33
08/11/2012,10,10,4,14,5,3,46
08/12/2012,9,7,2,6,8,0,32
08/13/2012,6,6,3,9,6,1,31
08/14/2012,8,5,5,11,10,1,40
08/15/2012,12,2,8,9,10,3,44
08/16/2012,15,5,3,10,11,2,46
08/17/2012,7,7,6,4,6,1,31
08/18/2012,9,2,2,4,8,4,29
08/19/2012,11,4,8,10,6,5,44
08/20/2012,7,3,5,15,9,3,42
08/21/2012,6,4,4,6,8,4,32
08/22/2012,9,10,2,3,4,3,31
08/23/2012,4,2,2,10,2,1,21
08/24/2012,11,2,2,9,6,4,34
08/25/2012,2,8,2,9,7,4,32
08/26/2012,6,7,3,10,10,1,37
08/27/2012,8,3,1,11,7,3,33
08/28/2012,10,5,0,9,5,2,31
08/29/2012,11,4,7,8,4,1,35
08/30/2012,5,4,5,8,6,2,30
08/31/2012,4,5,4,7,3,7,30
09/01/2012,8,5,2,6,6,2,29
09/02/2012,16,5,6,14,8,3,52
09/03/2012,5,4,5,18,2,1,35
09/04/2012,6,5,5,15,11,0,42
09/05/2012,16,5,1,3,11,2,38
09/06/2012,6,5,3,3,6,7,30
09/07/2012,6,3,4,10,5,5,33
09/08/2012,13,5,4,8,7,3,40
09/09/2012,6,4,3,6,7,1,27
09/10/2012,4,5,3,8,5,3,28
09/11/2012,5,3,5,5,7,4,29
09/12/2012,7,2,1,10,1,0,21
09/13/2012,2,1,1,9,7,1,21
09/14/2012,9,5,5,11,11,2,43
09/15/2012,11,5,2,6,10,3,37
09/16/2012,9,6,3,12,4,3,37
09/17/2012,7,4,2,13,2,7,35
09/18/2012,8,6,3,9,7,2,35
09/19/2012,11,0,4,11,7,3,36
09/20/2012,11,3,3,9,7,3,36
09/21/2012,7,2,5,14,7,6,41
09/22/2012,9,2,2,11,5,3,32
09/23/2012,11,3,5,8,7,1,35
09/24/2012,7,4,3,10,6,0,30
09/25/2012,16,1,6,12,6,2,43
09/26/2012,7,2,7,5,5,1,27
09/27/2012,6,3,3,6,2,1,21
09/28/2012,8,3,7,11,5,0,34
09/29/2012,10,4,5,13,5,2,39
09/30/2012,7,3,7,11,3,4,35
10/01/2012,7,1,5,9,7,3,32
10/02/2012,10,6,7,13,10,3,49
10/03/2012,9,4,3,22,4,2,44
10/04/2012,4,0,1,11,6,6,28
10/05/2012,10,4,4,15,4,2,39
10/06/2012,6,5,9,12,6,3,41
10/07/2012,8,4,2,8,6,2,30
10/08/2012,10,3,0,16,13,2,44
10/09/2012,7,2,3,7,6,0,25
10/10/2012,17,6,6,12,4,6,51
10/11/2012,11,3,3,8,6,2,33
10/12/2012,5,8,4,15,6,1,39
10/13/2012,14,2,3,17,3,4,43
10/14/2012,11,6,2,17,6,0,42
10/15/2012,3,4,4,19,11,2,43
10/16/2012,8,7,1,8,8,5,37
10/17/2012,9,6,3,9,7,1,35
10/18/2012,15,5,10,8,4,0,42
10/19/2012,7,6,1,11,3,4,32
10/20/2012,12,5,0,9,7,2,35
10/21/2012,11,8,4,10,12,0,45
10/22/2012,9,3,4,8,6,0,30
10/23/2012,8,1,2,9,7,3,30
10/24/2012,9,7,2,18,6,1,43
10/25/2012,3,3,2,10,7,6,31
10/26/2012,14,5,4,14,5,4,46
10/27/2012,15,5,3,12,15,1,51
10/28/2012,6,3,4,12,9,6,40
10/29/2012,10,5,2,14,10,6,47
10/30/2012,16,5,4,17,5,2,49
10/31/2012,9,0,5,12,12,2,40
11/01/2012,10,7,4,9,10,4,44
11/02/2012,13,6,2,14,5,3,43
11/03/2012,10,3,3,7,8,1,32
11/04/2012,8,7,8,16,2,1,42
11/05/2012,8,6,3,13,8,1,39
11/06/2012,17,2,3,10,2,0,34
11/07/2012,7,1,6,12,6,1,33
11/08/2012,11,6,2,15,16,3,53
11/09/2012,12,2,2,13,7,0,36
11/10/2012,11,5,4,13,3,3,39
11/11/2012,10,5,3,21,7,1,47
11/12/2012,15,2,6,22,6,3,54
11/13/2012,9,6,7,14,4,3,43
11/14/2012,10,5,4,10,11,0,40
11/15/2012,9,3,5,12,7,3,39
11/16/2012,9,4,4,15,12,4,48
11/17/2012,16,8,3,20,6,3,56
11/18/2012,11,7,5,10,5,2,40
11/19/2012,19,7,4,12,10,3,55
11/20/2012,14,3,2,9,8,2,38
11/21/2012,7,7,3,8,5,2,32
11/22/2012,9,1,6,13,5,5,39
11/23/2012,7,6,2,11,7,5,38
11/24/2012,15,6,6,13,4,2,46
11/25/2012,9,8,6,16,2,5,46
11/26/2012,16,2,2,20,8,2,50
11/27/2012,14,7,2,12,13,2,50
11/28/2012,6,6,4,11,8,2,37
11/29/2012,16,7,4,9,5,1,42
11/30/2012,13,3,3,16,5,1,41
12/01/2012,9,6,4,5,5,2,31
12/02/2012,13,3,8,12,8,5,49
12/03/2012,8,6,3,8,5,3,33
12/04/2012,13,8,0,16,11,1,49
12/05/2012,11,5,6,10,8,4,44
12/06/2012,10,5,1,8,5,0,29
12/07/2012,10,4,1,20,7,4,46
12/08/2012,7,1,3,13,7,1,32
12/09/2012,11,1,4,12,5,2,35
12/10/2012,13,4,1,10,5,3,36
12/11/2012,14,4,4,14,4,2,42
12/12/2012,6,4,2,11,9,0,32
12/13/2012,11,5,5,14,8,1,44
12/14/2012,14,7,1,9,8,4,43
12/15/2012,11,6,7,11,5,6,46
12/16/2012,20,8,6,13,6,5,58
12/17/2012,10,5,5,12,9,0,41
12/18/2012,7,4,6,13,14,6,50
12/19/2012,7,5,2,11,7,3,35
12/20/2012,6,5,6,11,4,1,33
12/21/2012,6,2,5,12,2,4,31
12/22/2012,8,10,5,11,0,4,38
12/23/2012,21,5,2,10,6,3,47
12/24/2012,8,7,4,8,9,1,37
12/25/2012,8,5,3,11,6,10,43
12/26/2012,12,3,7,12,2,3,39
12/27/2012,6,5,7,11,4,1,34
12/28/2012,5,7,2,2,0,1,17
12/29/2012,1,0,1,2,2,0,6
12/30/2012,4,1,1,1,0,0,7
12/31/2012,2,1,0,4,0,1,8
01/01/2013,24,4,5,28,17,2,80
01/02/2013,10,5,3,23,9,3,53
01/03/2013,7,4,7,10,3,5,36
01/04/2013,12,3,2,4,9,2,32
01/05/2013,15,2,3,9,6,1,36
01/06/2013,12,7,3,12,13,5,52
01/07/2013,9,6,0,9,7,2,33
01/08/2013,9,2,6,10,4,1,32
01/09/2013,12,4,0,9,7,4,36
01/10/2013,8,5,2,6,10,2,33
01/11/2013,13,9,2,19,7,8,58
01/12/2013,13,13,10,9,6,4,55
01/13/2013,11,3,6,16,9,3,48
01/14/2013,12,4,7,18,7,1,49
01/15/2013,26,2,5,6,2,1,42
01/16/2013,10,1,4,12,3,3,33
01/17/2013,9,8,6,14,8,3,48
01/18/2013,16,7,4,24,7,0,58
01/19/2013,10,6,3,13,7,5,44
01/20/2013,14,2,5,11,10,4,46
01/21/2013,20,5,2,7,3,0,37
01/22/2013,14,1,7,9,7,2,40
01/23/2013,11,5,3,19,2,3,43
01/24/2013,15,3,8,8,3,4,41
01/25/2013,7,6,6,18,6,1,44
01/26/2013,13,6,3,11,7,0,40
01/27/2013,15,6,7,14,8,1,51
01/28/2013,14,8,4,16,5,5,52
01/29/2013,3,4,3,10,7,0,27
01/30/2013,9,3,3,11,4,0,30
01/31/2013,12,5,7,12,5,6,47
02/01/2013,11,5,4,11,8,1,40
02/02/2013,8,7,3,22,5,1,46
02/03/2013,17,8,8,19,13,2,67
02/04/2013,8,4,3,15,6,4,40
02/05/2013,6,4,3,14,8,0,35
02/06/2013,8,5,6,13,13,1,46
02/07/2013,9,4,3,11,11,2,40
02/08/2013,12,9,4,8,11,1,45
02/09/2013,12,6,6,16,7,3,50
02/10/2013,10,9,5,20,5,3,52
02/11/2013,8,2,0,19,6,4,39
02/12/2013,10,5,6,12,6,1,40
02/13/2013,7,3,2,20,7,1,40
02/14/2013,11,7,2,16,9,5,50
02/15/2013,25,6,10,12,3,2,58
02/16/2013,12,6,6,23,10,3,60
02/17/2013,16,4,7,18,9,2,56
02/18/2013,16,7,2,8,6,2,41
02/19/2013,8,2,3,13,4,1,31
02/20/2013,8,10,3,14,2,4,41
02/21/2013,7,7,2,11,3,3,33
02/22/2013,8,7,2,15,8,5,45
02/23/2013,12,1,4,15,7,3,42
02/24/2013,12,6,5,15,12,5,55
02/25/2013,9,1,5,13,9,3,40
02/26/2013,8,4,4,7,4,1,28
02/27/2013,18,3,7,12,6,5,51
02/28/2013,11,3,2,21,6,3,46
03/01/2013,13,9,10,8,6,5,51
03/02/2013,13,4,5,10,5,3,40
03/03/2013,16,11,5,26,1,1,60
03/04/2013,12,2,3,11,3,3,34
03/05/2013,9,5,9,10,3,2,38
03/06/2013,7,12,8,8,9,3,47
03/07/2013,8,6,4,17,6,0,41
03/08/2013,7,6,3,11,10,7,44
03/09/2013,17,10,6,16,13,1,63
03/10/2013,25,5,4,14,9,5,62
03/11/2013,10,4,5,17,9,2,47
03/12/2013,10,4,5,10,3,3,35
03/13/2013,10,3,4,17,9,2,45
03/14/2013,19,5,6,13,7,1,51
03/15/2013,10,6,4,20,8,2,50
03/16/2013,20,3,8,20,13,1,65
03/17/2013,11,7,10,14,4,6,52
03/18/2013,10,6,4,23,10,4,57
03/19/2013,7,4,6,17,7,1,42
03/20/2013,14,2,7,12,8,1,44
03/21/2013,15,8,1,12,9,3,48
03/22/2013,12,9,7,11,13,2,54
03/23/2013,15,8,4,21,5,2,55
03/24/2013,14,6,6,15,7,1,49
03/25/2013,14,8,4,5,10,2,43
03/26/2013,13,10,9,17,8,1,58
03/27/2013,11,7,6,14,14,3,55
03/28/2013,10,8,12,12,4,3,49
03/29/2013,12,6,5,13,8,1,45
03/30/2013,10,10,7,10,7,3,47
03/31/2013,17,8,3,19,6,1,54
04/01/2013,19,6,7,13,11,2,58
04/02/2013,14,5,5,16,9,2,51
04/03/2013,12,4,2,18,8,2,46
04/04/2013,14,7,1,21,6,4,53
04/05/2013,11,7,7,18,5,1,49
04/06/2013,15,6,4,16,7,4,52
04/07/2013,10,8,6,14,13,2,53
04/08/2013,18,7,5,12,11,3,56
04/09/2013,8,4,5,12,8,3,40
04/10/2013,9,5,0,21,8,5,48
04/11/2013,10,4,6,19,3,9,51
04/12/2013,20,6,10,28,6,5,75
04/13/2013,27,9,11,36,14,9,106
04/14/2013,20,4,4,25,8,3,64
04/15/2013,16,9,9,19,1,2,56
04/16/2013,18,1,4,26,2,2,53
04/17/2013,14,3,6,14,6,0,43
04/18/2013,9,1,3,22,8,3,46
04/19/2013,12,2,9,13,5,6,47
04/20/2013,5,6,7,15,10,1,44
04/21/2013,12,0,5,11,7,2,37
04/22/2013,17,4,4,11,1,2,39
04/23/2013,11,4,5,16,5,4,45
04/24/2013,9,3,4,11,6,3,36
04/25/2013,11,5,2,21,9,3,51
04/26/2013,10,1,4,12,10,4,41
04/27/2013,14,8,3,10,6,1,42
04/28/2013,18,9,9,10,9,2,57
04/29/2013,12,7,7,14,6,4,50
04/30/2013,13,4,3,12,8,3,43
05/01/2013,23,9,9,14,9,1,65
05/02/2013,12,4,5,9,6,2,38
05/03/2013,17,4,5,20,3,2,51
05/04/2013,15,5,5,20,7,5,57
05/05/2013,16,6,5,14,10,7,58
05/06/2013,11,8,6,13,4,7,49
05/07/2013,15,4,2,13,9,9,52
05/08/2013,5,4,6,10,3,3,31
05/09/2013,12,4,4,11,6,4,41
05/10/2013,6,3,5,17,6,4,41
05/11/2013,14,6,4,13,6,5,48
05/12/2013,8,6,5,19,4,1,43
05/13/2013,22,5,3,13,5,3,51
05/14/2013,12,7,7,16,8,3,53
05/15/2013,12,9,6,11,13,5,56
05/16/2013,16,3,5,10,8,6,48
05/17/2013,13,3,3,18,9,2,48
05/18/2013,14,9,6,19,9,3,60
05/19/2013,12,6,2,11,12,4,47
05/20/2013,11,6,8,16,13,2,56
05/21/2013,9,4,4,13,11,1,42
05/22/2013,16,6,5,9,2,3,41
05/23/2013,4,6,2,9,5,1,27
05/24/2013,9,6,6,11,17,2,51
05/25/2013,9,9,4,17,8,4,51
05/26/2013,30,7,4,12,10,10,73
05/27/2013,15,3,5,18,3,4,48
05/28/2013,11,6,4,9,11,1,42
05/29/2013,13,2,2,14,2,3,36
05/30/2013,15,5,3,12,6,4,45
05/31/2013,11,4,6,15,6,4,46
06/01/2013,18,6,6,23,13,8,74
06/02/2013,12,16,5,24,10,1,68
06/03/2013,16,6,6,15,2,5,50
06/04/2013,14,5,3,15,3,4,44
06/05/2013,18,3,5,10,5,0,41
06/06/2013,14,3,3,10,9,2,41
06/07/2013,16,4,6,16,5,4,51
06/08/2013,13,6,5,13,5,3,45
06/09/2013,16,8,3,18,6,3,54
06/10/2013,19,6,4,14,7,3,53
06/11/2013,10,6,5,11,9,2,43
06/12/2013,5,5,4,11,5,1,31
06/13/2013,7,4,10,11,5,2,39
06/14/2013,18,17,3,19,4,2,63
06/15/2013,20,6,7,18,9,4,64
06/16/2013,23,4,6,17,0,4,54
06/17/2013,18,6,4,14,15,6,63
06/18/2013,7,6,1,18,5,1,38
06/19/2013,10,7,6,15,9,3,50
06/20/2013,15,13,4,12,5,2,51
06/21/2013,17,1,1,11,3,3,36
06/22/2013,15,3,7,18,6,4,53
06/23/2013,13,4,5,13,5,2,42
06/24/2013,10,7,2,19,4,2,44
06/25/2013,12,2,4,10,4,2,34
06/26/2013,9,5,5,10,7,2,38
06/27/2013,18,7,2,15,4,1,47
06/28/2013,18,4,5,9,11,2,49
06/29/2013,25,8,5,10,8,5,61
06/30/2013,13,6,8,10,17,6,60
07/01/2013,13,5,6,9,4,5,42
07/02/2013,24,3,7,17,7,4,62
07/03/2013,16,6,4,14,4,3,47
07/04/2013,12,5,9,9,8,3,46
07/05/2013,15,12,3,11,8,2,51
07/06/2013,10,3,5,18,6,2,44
07/07/2013,24,11,9,15,6,6,71
07/08/2013,23,1,6,20,9,1,60
07/09/2013,5,8,4,9,9,4,39
07/10/2013,14,6,4,14,6,3,47
07/11/2013,19,5,3,14,11,4,56
07/12/2013,17,6,5,6,10,2,46
07/13/2013,15,8,4,7,11,6,51
07/14/2013,14,3,3,7,11,5,43
07/15/2013,20,2,6,14,7,1,50
07/16/2013,14,9,3,14,5,2,47
07/17/2013,16,3,2,13,1,4,39
07/18/2013,16,4,3,19,7,1,50
07/19/2013,17,7,3,10,4,2,43
07/20/2013,15,13,4,19,7,2,60
07/21/2013,15,9,3,15,10,5,57
07/22/2013,18,4,6,10,5,4,47
07/23/2013,21,4,4,13,5,3,50
07/24/2013,7,3,2,8,4,3,27
07/25/2013,10,3,3,5,11,1,33
07/26/2013,10,4,2,7,14,1,38
07/27/2013,7,8,6,8,10,3,42
07/28/2013,18,6,3,12,5,5,49
07/29/2013,10,3,2,6,4,0,25
07/30/2013,17,10,5,5,5,1,43
07/31/2013,11,7,4,13,4,4,43
08/01/2013,7,7,2,9,5,6,36
08/02/2013,19,7,4,11,5,2,48
08/03/2013,16,3,6,18,6,6,55
08/04/2013,11,10,4,14,6,2,47
08/05/2013,15,2,2,17,5,2,43
08/06/2013,14,5,4,5,7,1,36
08/07/2013,17,7,5,7,4,2,42
08/08/2013,11,6,7,4,6,1,35
08/09/2013,10,4,4,12,10,2,42
08/10/2013,14,8,3,11,15,5,56
08/11/2013,13,8,4,10,8,4,47
08/12/2013,11,5,6,18,3,4,47
08/13/2013,12,4,2,7,9,2,36
08/14/2013,12,8,3,8,4,9,44
08/15/2013,13,4,3,13,13,3,49
08/16/2013,7,5,6,7,8,2,35
08/17/2013,19,4,4,13,10,1,51
08/18/2013,13,9,6,21,5,3,57
08/19/2013,16,3,6,11,9,1,46
08/20/2013,13,6,5,12,5,1,42
08/21/2013,6,5,9,13,5,3,41
08/22/2013,11,4,3,14,11,0,43
08/23/2013,7,3,4,14,3,5,36
08/24/2013,1,9,4,12,10,3,39
08/25/2013,13,6,5,15,6,4,49
08/26/2013,16,14,4,15,4,1,54
08/27/2013,14,7,2,17,5,2,47
08/28/2013,20,7,2,10,4,1,44
08/29/2013,18,2,3,5,4,3,35
08/30/2013,11,5,6,15,4,1,42
08/31/2013,20,1,6,17,11,6,61
09/01/2013,19,6,1,19,9,4,58
09/02/2013,13,2,3,9,5,2,34
09/03/2013,12,14,5,16,4,3,54
09/04/2013,11,8,4,10,8,3,44
09/05/2013,15,10,3,15,14,3,60
09/06/2013,14,1,9,12,10,1,47
09/07/2013,11,9,4,7,2,7,40
09/08/2013,11,3,7,10,10,5,46
09/09/2013,11,3,7,12,6,5,44
09/10/2013,13,5,5,12,2,2,39
09/11/2013,13,11,5,11,6,5,51
09/12/2013,8,3,3,12,8,4,38
09/13/2013,17,7,8,16,6,5,59
09/14/2013,13,3,2,9,5,4,36
09/15/2013,13,5,3,9,5,1,36
09/16/2013,10,5,7,10,6,5,43
09/17/2013,16,6,6,9,5,4,46
09/18/2013,9,6,4,13,5,3,40
09/19/2013,9,5,4,14,8,0,40
09/20/2013,9,4,5,14,8,3,43
09/21/2013,10,5,5,9,8,3,40
09/22/2013,8,9,6,7,7,1,38
09/23/2013,10,9,4,12,5,1,41
09/24/2013,7,3,5,13,5,6,39
09/25/2013,7,6,4,9,9,4,39
09/26/2013,10,7,7,15,13,0,52
09/27/2013,18,4,5,15,11,1,54
09/28/2013,14,3,4,15,8,2,46
09/29/2013,15,3,13,11,2,3,47
09/30/2013,14,2,7,16,9,4,52
10/01/2013,15,7,7,10,9,2,50
10/02/2013,18,3,6,10,5,2,44
10/03/2013,13,5,5,14,10,4,51
10/04/2013,21,5,3,14,9,2,54
10/05/2013,12,6,2,16,7,2,45
10/06/2013,11,3,4,13,5,2,38
10/07/2013,13,4,4,16,7,3,47
10/08/2013,13,5,4,15,6,3,46
10/09/2013,15,4,6,16,11,2,54
10/10/2013,12,5,5,12,5,2,41
10/11/2013,11,5,5,10,16,0,47
10/12/2013,13,4,7,17,7,7,55
10/13/2013,17,3,5,14,6,2,47
10/14/2013,12,5,2,19,8,4,50
10/15/2013,14,9,4,9,6,1,43
10/16/2013,9,7,5,9,6,1,37
10/17/2013,13,3,14,5,7,5,47
10/18/2013,13,10,3,17,13,2,58
10/19/2013,12,6,4,16,7,1,46
10/20/2013,24,9,4,25,3,0,65
10/21/2013,16,6,9,11,5,1,48
10/22/2013,8,8,4,17,6,2,45
10/23/2013,10,4,25,15,9,1,64
10/24/2013,12,2,5,13,6,3,41
10/25/2013,14,6,5,15,7,2,49
10/26/2013,15,17,5,14,9,1,61
10/27/2013,10,7,3,9,12,4,45
10/28/2013,12,7,5,10,7,6,47
10/29/2013,11,7,3,13,3,5,42
10/30/2013,18,6,6,11,9,4,54
10/31/2013,12,3,5,15,3,1,39
11/01/2013,21,9,10,12,5,3,60
11/02/2013,23,8,6,18,10,7,72
11/03/2013,22,12,7,16,12,5,74
11/04/2013,22,10,6,6,11,3,58
11/05/2013,8,8,4,24,9,4,57
11/06/2013,10,11,1,20,7,3,52
11/07/2013,9,7,6,10,12,1,45
11/08/2013,16,3,3,20,6,3,51
11/09/2013,25,10,6,23,10,2,76
11/10/2013,20,8,7,28,13,3,79
11/11/2013,7,7,6,20,5,1,46
11/12/2013,16,6,6,15,8,3,54
11/13/2013,8,2,10,19,7,5,51
11/14/2013,15,4,5,6,7,2,39
11/15/2013,10,5,8,11,5,3,42
11/16/2013,20,12,14,17,8,4,75
11/17/2013,26,10,11,33,5,3,88
11/18/2013,24,16,4,17,10,5,76
11/19/2013,22,5,3,18,2,4,54
11/20/2013,14,8,3,13,3,2,43
11/21/2013,13,1,4,22,9,2,51
11/22/2013,18,6,2,25,7,6,64
11/23/2013,18,9,1,17,7,4,56
11/24/2013,16,5,2,24,4,2,53
11/25/2013,11,4,3,17,7,3,45
11/26/2013,21,5,7,16,4,2,55
11/27/2013,11,9,6,4,11,3,44
11/28/2013,9,4,4,18,8,3,46
11/29/2013,18,6,7,19,11,3,64
11/30/2013,15,10,9,14,6,3,57
12/01/2013,21,13,7,16,4,10,71
12/02/2013,22,10,2,13,4,4,55
12/03/2013,15,9,5,20,7,2,58
12/04/2013,23,6,5,21,9,2,66
12/05/2013,20,5,7,15,5,9,61
12/06/2013,13,7,8,13,6,4,51
12/07/2013,20,7,10,24,5,5,71
12/08/2013,15,6,6,18,5,5,55
12/09/2013,14,5,8,14,6,1,48
12/10/2013,12,9,12,16,13,3,65
12/11/2013,23,10,8,15,5,5,66
12/12/2013,14,8,6,18,8,2,56
12/13/2013,9,10,4,21,6,3,53
12/14/2013,18,7,5,18,9,2,59
12/15/2013,17,13,13,28,5,1,77
12/16/2013,9,8,3,13,5,6,44
12/17/2013,12,11,4,9,5,3,44
12/18/2013,16,7,10,14,6,5,58
12/19/2013,11,9,3,14,5,4,46
12/20/2013,17,8,6,20,7,3,61
12/21/2013,11,17,7,18,5,4,62
12/22/2013,17,9,13,16,1,5,61
12/23/2013,19,9,3,14,7,2,54
12/24/2013,27,13,8,16,7,8,79
12/25/2013,20,9,10,13,8,1,61
12/26/2013,31,5,8,14,4,1,63
12/27/2013,22,5,4,11,6,2,50
12/28/2013,24,7,6,13,4,1,55
12/29/2013,12,3,5,12,4,1,37
12/30/2013,9,4,7,18,6,3,47
12/31/2013,14,8,6,20,1,2,51
01/01/2014,26,8,8,42,11,8,103
01/02/2014,25,2,3,11,3,5,49
01/03/2014,16,13,6,17,10,3,65
01/04/2014,16,7,6,22,10,3,64
01/05/2014,18,6,5,14,11,6,60
01/06/2014,14,6,16,13,8,2,59
01/07/2014,20,9,4,17,4,7,61
01/08/2014,15,10,3,13,6,3,50
01/09/2014,10,6,8,12,10,2,48
01/10/2014,13,13,4,17,5,2,54
01/11/2014,16,9,9,19,7,4,64
01/12/2014,17,8,6,17,9,3,60
01/13/2014,19,13,7,18,12,1,70
01/14/2014,11,4,6,13,8,3,45
01/15/2014,11,6,8,13,7,1,46
01/16/2014,22,8,8,27,4,6,75
01/17/2014,20,6,2,9,13,7,57
01/18/2014,18,9,8,27,7,4,73
01/19/2014,27,13,6,22,7,3,78
01/20/2014,10,4,3,12,15,2,46
01/21/2014,13,6,6,13,8,2,48
01/22/2014,14,6,6,9,11,5,51
01/23/2014,14,8,4,11,13,2,52
01/24/2014,12,11,6,15,5,2,51
01/25/2014,20,15,10,23,4,3,75
01/26/2014,21,7,6,20,9,7,70
01/27/2014,22,5,5,16,6,4,58
01/28/2014,18,4,3,14,9,4,52
01/29/2014,20,10,4,22,15,5,76
01/30/2014,13,3,8,17,14,4,59
01/31/2014,27,15,7,21,12,2,84
02/01/2014,24,5,4,22,8,3,66
02/02/2014,20,13,7,24,8,4,76
02/03/2014,22,7,3,19,10,6,67
02/04/2014,22,3,6,18,6,2,57
02/05/2014,20,6,11,12,14,2,65
02/06/2014,15,7,6,13,11,4,56
02/07/2014,17,7,11,12,10,7,64
02/08/2014,9,3,4,12,11,5,44
02/09/2014,18,10,1,22,4,7,62
02/10/2014,20,10,8,12,13,3,66
02/11/2014,17,5,5,21,8,2,58
02/12/2014,15,8,9,15,10,3,60
02/13/2014,21,11,4,19,7,1,63
02/14/2014,21,11,7,21,4,3,67
02/15/2014,21,7,7,15,9,1,60
02/16/2014,23,9,3,16,14,4,69
02/17/2014,13,7,3,18,7,8,56
02/18/2014,15,5,5,11,11,1,48
02/19/2014,16,9,11,22,7,7,72
02/20/2014,10,6,3,23,5,2,49
02/21/2014,15,8,7,21,7,4,62
02/22/2014,25,4,10,19,14,1,73
02/23/2014,17,9,7,21,5,0,59
02/24/2014,22,5,5,21,5,2,60
02/25/2014,16,6,11,26,6,5,70
02/26/2014,12,7,8,19,8,4,58
02/27/2014,9,6,9,16,10,3,53
02/28/2014,16,26,7,12,13,2,76
03/01/2014,10,11,12,23,7,4,67
03/02/2014,16,7,5,22,5,2,57
03/03/2014,24,6,11,15,14,4,74
03/04/2014,11,3,9,18,8,5,54
03/05/2014,12,6,6,19,8,6,57
03/06/2014,18,7,2,24,12,2,65
03/07/2014,14,5,4,20,5,2,50
03/08/2014,17,11,7,27,11,6,79
03/09/2014,30,5,8,27,5,5,80
03/10/2014,24,7,7,18,5,4,65
03/11/2014,12,3,5,25,12,6,63
03/12/2014,19,10,3,27,12,3,74
03/13/2014,17,9,12,14,12,3,67
03/14/2014,15,2,7,20,12,1,57
03/15/2014,26,9,13,23,17,2,90
03/16/2014,25,3,5,12,8,2,55
03/17/2014,18,5,4,19,7,2,55
03/18/2014,19,8,6,14,7,3,57
03/19/2014,20,5,4,9,7,7,52
03/20/2014,20,9,10,6,5,0,50
03/21/2014,9,3,6,14,8,2,42
03/22/2014,17,12,4,15,10,2,60
03/23/2014,15,6,7,12,11,2,53
03/24/2014,13,3,4,19,3,26,68
03/25/2014,11,7,4,11,7,2,42
03/26/2014,17,2,7,16,15,6,63
03/27/2014,12,7,3,19,11,2,54
03/28/2014,13,9,7,9,1,3,42
03/29/2014,24,4,3,14,6,6,57
03/30/2014,14,9,4,10,4,3,44
03/31/2014,8,7,6,13,8,3,45
04/01/2014,14,7,1,18,7,3,50
04/02/2014,12,7,5,14,9,4,51
04/03/2014,10,9,13,13,9,5,59
04/04/2014,20,3,10,15,4,6,58
04/05/2014,20,10,6,12,7,2,57
04/06/2014,24,7,6,15,6,5,63
04/07/2014,10,10,10,29,8,1,68
04/08/2014,13,2,3,13,5,2,38
04/09/2014,19,5,3,14,8,3,52
04/10/2014,26,7,7,11,2,2,55
04/11/2014,18,7,10,23,8,7,73
04/12/2014,24,9,11,31,6,5,86
04/13/2014,21,6,8,31,6,5,77
04/14/2014,20,4,11,15,7,3,60
04/15/2014,14,10,14,17,8,3,66
04/16/2014,17,5,3,7,7,2,41
04/17/2014,17,4,4,12,7,7,51
04/18/2014,15,11,0,8,5,6,45
04/19/2014,15,5,4,9,4,0,37
04/20/2014,16,5,4,20,8,3,56
04/21/2014,11,5,3,7,5,2,33
04/22/2014,7,9,3,12,6,5,42
04/23/2014,5,2,6,12,7,4,36
04/24/2014,11,6,5,13,4,7,46
04/25/2014,12,7,8,8,3,4,42
04/26/2014,15,5,7,14,8,5,54
04/27/2014,20,1,8,5,3,5,42
04/28/2014,17,5,4,8,6,4,44
04/29/2014,6,8,2,15,9,5,45
04/30/2014,12,6,5,11,0,17,51
05/01/2014,11,7,7,28,10,5,68
05/02/2014,20,5,3,11,9,1,49
05/03/2014,10,6,4,17,13,3,53
05/04/2014,11,7,5,15,10,4,52
05/05/2014,13,11,8,12,10,4,58
05/06/2014,11,5,4,20,5,7,52
05/07/2014,8,8,4,18,2,2,42
05/08/2014,22,5,4,20,4,2,57
05/09/2014,13,7,2,15,7,5,49
05/10/2014,20,5,7,14,8,2,56
05/11/2014,11,6,6,17,4,3,47
05/12/2014,14,5,8,16,7,2,52
05/13/2014,18,4,5,19,6,1,53
05/14/2014,14,4,1,8,10,4,41
05/15/2014,11,4,6,22,5,1,49
05/16/2014,14,4,5,12,11,3,49
05/17/2014,9,4,5,18,12,2,50
05/18/2014,15,6,3,17,4,3,48
05/19/2014,19,4,6,9,4,4,46
05/20/2014,12,7,8,11,3,0,41
05/21/2014,13,6,7,17,7,3,53
05/22/2014,6,2,6,15,8,3,40
05/23/2014,13,1,3,14,7,4,42
05/24/2014,10,4,2,19,9,2,46
05/25/2014,11,10,6,17,6,1,51
05/26/2014,16,3,6,10,7,1,43
05/27/2014,12,5,5,10,6,0,38
05/28/2014,9,6,4,10,6,3,38
05/29/2014,8,7,2,18,10,0,45
05/30/2014,5,3,4,14,5,2,33
05/31/2014,14,7,8,14,7,3,53
06/01/2014,19,12,4,11,10,6,62
06/02/2014,14,1,6,20,3,2,46
06/03/2014,16,9,1,19,4,5,54
06/04/2014,10,5,3,13,8,5,44
06/05/2014,14,5,5,12,4,6,46
06/06/2014,12,7,5,16,9,1,50
06/07/2014,12,10,5,19,2,4,52
06/08/2014,11,7,3,10,5,2,38
06/09/2014,15,9,4,21,10,3,62
06/10/2014,10,5,6,5,9,4,39
06/11/2014,8,8,8,18,4,4,50
06/12/2014,14,5,8,17,9,2,55
06/13/2014,16,4,4,14,5,4,47
06/14/2014,13,3,8,8,12,1,45
06/15/2014,14,6,5,16,2,1,44
06/16/2014,10,5,7,17,11,2,52
06/17/2014,11,6,3,8,8,4,40
06/18/2014,10,3,5,12,5,0,35
06/19/2014,6,7,3,6,4,4,30
06/20/2014,13,1,3,10,5,4,36
06/21/2014,16,7,3,11,14,0,51
06/22/2014,20,4,6,18,13,6,67
06/23/2014,11,4,4,17,9,2,47
06/24/2014,8,8,1,9,6,3,35
06/25/2014,10,8,3,9,5,2,37
06/26/2014,7,3,6,8,6,5,35
06/27/2014,13,8,11,8,4,4,48
06/28/2014,18,7,4,25,4,4,62
06/29/2014,18,9,3,17,9,0,56
06/30/2014,11,7,7,9,6,4,44
07/01/2014,14,11,4,11,8,4,52
07/02/2014,14,5,11,8,7,5,50
07/03/2014,21,9,7,8,6,4,55
07/04/2014,18,9,5,16,10,3,61
07/05/2014,11,6,3,19,6,4,49
07/06/2014,14,9,2,17,7,5,54
07/07/2014,16,11,3,8,8,5,51
07/08/2014,15,6,5,13,5,1,45
07/09/2014,13,4,4,5,5,3,34
07/10/2014,11,8,5,12,12,1,49
07/11/2014,15,7,4,7,6,6,45
07/12/2014,8,2,5,11,10,1,37
07/13/2014,15,12,2,9,2,2,42
07/14/2014,10,2,7,9,1,2,31
07/15/2014,8,2,2,8,12,7,39
07/16/2014,11,1,2,15,6,1,36
07/17/2014,13,6,3,10,6,2,40
07/18/2014,17,3,1,9,3,3,36
07/19/2014,7,9,6,10,12,2,46
07/20/2014,6,9,5,9,4,5,38
07/21/2014,12,5,3,9,3,0,32
07/22/2014,15,1,5,3,3,1,28
07/23/2014,14,3,6,7,5,4,39
07/24/2014,9,4,3,8,7,2,33
07/25/2014,4,6,1,7,7,5,30
07/26/2014,14,5,2,15,1,4,41
07/27/2014,23,4,5,7,9,4,52
07/28/2014,14,5,3,16,11,5,54
07/29/2014,12,8,4,8,9,4,45
07/30/2014,19,4,2,11,6,2,44
07/31/2014,11,5,2,7,8,1,34
08/01/2014,12,3,8,10,7,3,43
08/02/2014,13,9,12,6,4,7,51
08/03/2014,18,0,10,9,5,4,46
08/04/2014,15,7,4,7,10,4,47
08/05/2014,7,5,2,11,10,7,42
08/06/2014,14,3,6,10,5,3,41
08/07/2014,15,3,3,6,8,3,38
08/08/2014,13,4,3,9,11,1,41
08/09/2014,10,5,3,11,4,3,36
08/10/2014,21,7,0,16,6,6,56
08/11/2014,11,10,3,16,4,6,50
08/12/2014,13,6,7,9,7,3,45
08/13/2014,9,2,2,8,8,3,32
08/14/2014,8,6,6,12,8,5,45
08/15/2014,6,7,5,10,10,1,39
08/16/2014,10,6,2,13,7,0,38
08/17/2014,12,5,4,19,19,2,61
08/18/2014,14,2,3,15,11,3,48
08/19/2014,15,5,3,12,7,2,44
08/20/2014,13,6,3,8,7,1,38
08/21/2014,7,5,7,10,7,0,36
08/22/2014,8,2,6,9,12,3,40
08/23/2014,9,5,6,10,6,2,38
08/24/2014,17,7,5,16,8,3,56
08/25/2014,11,4,2,18,6,0,41
08/26/2014,8,3,4,13,6,1,35
08/27/2014,12,2,4,9,4,2,33
08/28/2014,13,3,4,8,8,4,40
08/29/2014,15,8,3,12,11,0,49
08/30/2014,13,3,6,8,7,0,37
08/31/2014,12,10,5,14,9,0,50
09/01/2014,16,8,3,11,8,0,46
09/02/2014,7,3,11,18,5,0,44
09/03/2014,8,3,4,5,7,2,29
09/04/2014,11,1,5,9,8,4,38
09/05/2014,16,9,6,8,5,3,47
09/06/2014,18,6,8,17,8,4,61
09/07/2014,20,7,4,11,6,3,51
09/08/2014,14,4,4,14,3,3,42
09/09/2014,8,4,8,10,2,2,34
09/10/2014,10,5,1,13,4,3,36
09/11/2014,10,6,0,7,4,2,29
09/12/2014,10,4,6,12,8,0,40
09/13/2014,13,7,7,8,10,2,47
09/14/2014,11,7,3,9,10,2,42
09/15/2014,7,4,6,15,7,2,41
09/16/2014,16,5,5,8,8,2,44
09/17/2014,12,7,1,9,4,1,34
09/18/2014,14,3,4,8,12,2,43
09/19/2014,12,6,12,15,9,2,56
09/20/2014,13,7,5,10,14,2,51
09/21/2014,7,14,5,11,4,5,46
09/22/2014,12,2,4,11,8,3,40
09/23/2014,7,5,3,10,4,2,31
09/24/2014,19,3,6,7,10,1,46
09/25/2014,10,8,5,5,12,0,40
09/26/2014,10,8,3,9,6,3,39
09/27/2014,14,9,8,10,8,2,51
09/28/2014,19,11,2,11,6,2,51
09/29/2014,15,4,6,13,3,2,43
09/30/2014,10,4,1,12,10,3,40
10/01/2014,19,2,6,17,7,0,51
10/02/2014,16,7,7,17,6,3,56
10/03/2014,12,4,3,8,5,4,36
10/04/2014,21,8,1,12,11,9,62
10/05/2014,12,3,10,14,5,3,47
10/06/2014,10,4,2,10,8,3,37
10/07/2014,16,2,4,21,10,3,56
10/08/2014,12,8,1,13,3,0,37
10/09/2014,16,9,5,26,1,0,57
10/10/2014,19,6,8,10,2,3,48
10/11/2014,10,4,6,17,10,0,47
10/12/2014,9,8,7,13,5,5,47
10/13/2014,11,5,4,16,5,9,50
10/14/2014,8,3,5,12,5,5,38
10/15/2014,14,3,5,9,7,1,39
10/16/2014,6,6,5,8,8,6,39
10/17/2014,13,4,5,10,9,6,47
10/18/2014,21,3,2,10,7,6,49
10/19/2014,27,8,8,13,10,3,69
10/20/2014,14,4,3,18,7,2,48
10/21/2014,24,3,3,13,4,1,48
10/22/2014,13,9,2,12,7,0,43
10/23/2014,10,5,9,15,5,2,46
10/24/2014,6,6,2,13,4,3,34
10/25/2014,12,3,2,17,5,2,41
10/26/2014,18,8,4,14,8,3,55
10/27/2014,17,7,9,19,4,4,60
10/28/2014,11,3,11,16,10,7,58
10/29/2014,11,3,3,11,7,4,39
10/30/2014,10,5,8,12,6,1,42
10/31/2014,16,6,4,10,4,2,42
11/01/2014,12,8,7,11,4,4,46
11/02/2014,21,4,8,17,2,2,54
11/03/2014,21,7,2,9,6,3,48
11/04/2014,12,3,4,12,8,5,44
11/05/2014,8,4,2,16,5,1,36
11/06/2014,11,10,5,10,3,6,45
11/07/2014,19,9,8,23,4,3,66
11/08/2014,13,6,5,19,2,2,47
11/09/2014,12,4,6,18,10,5,55
11/10/2014,17,3,3,19,8,4,54
11/11/2014,7,6,5,13,5,2,38
11/12/2014,10,4,4,15,4,4,41
11/13/2014,21,4,8,13,9,2,57
11/14/2014,16,8,9,16,3,5,57
11/15/2014,14,6,7,23,6,2,58
11/16/2014,16,14,4,15,11,3,63
11/17/2014,10,5,7,14,4,3,43
11/18/2014,9,2,5,16,3,3,38
11/19/2014,16,6,5,9,6,9,51
11/20/2014,11,5,4,15,12,1,48
11/21/2014,13,8,2,6,8,1,38
11/22/2014,18,7,4,17,2,3,51
11/23/2014,18,8,9,14,7,2,58
11/24/2014,16,6,7,15,4,3,51
11/25/2014,16,6,7,17,8,2,56
11/26/2014,16,7,7,15,4,0,49
11/27/2014,16,6,10,18,2,3,55
11/28/2014,19,12,8,26,7,2,74
11/29/2014,13,5,7,20,5,10,60
11/30/2014,21,6,5,15,10,2,59
12/01/2014,16,6,15,7,9,2,55
12/02/2014,12,8,5,14,3,1,43
12/03/2014,14,4,9,18,9,6,60
12/04/2014,16,7,6,15,10,4,58
12/05/2014,12,8,4,11,4,3,42
12/06/2014,9,3,6,12,7,1,38
12/07/2014,16,12,6,12,5,5,56
12/08/2014,19,7,5,13,3,1,48
12/09/2014,13,10,9,23,1,3,59
12/10/2014,14,1,7,12,2,5,41
12/11/2014,16,3,4,15,4,1,43
12/12/2014,13,7,8,19,5,2,54
12/13/2014,13,9,13,16,9,5,65
12/14/2014,22,5,7,14,5,2,55
12/15/2014,19,8,5,12,6,3,53
12/16/2014,24,7,6,9,3,3,52
12/17/2014,20,7,9,18,4,4,62
12/18/2014,17,9,12,15,4,4,61
12/19/2014,19,3,13,16,1,1,53
12/20/2014,20,9,9,32,4,4,78
12/21/2014,23,7,7,17,4,6,64
12/22/2014,20,7,7,14,4,1,53
12/23/2014,12,6,6,22,0,4,50
12/24/2014,16,6,7,11,10,5,55
12/25/2014,14,6,6,13,7,3,49
12/26/2014,28,9,7,31,6,7,88
12/27/2014,18,8,8,28,4,4,70
12/28/2014,21,7,5,20,2,1,56
12/29/2014,25,8,6,16,3,7,65
12/30/2014,18,7,6,18,5,7,61
12/31/2014,14,6,8,25,3,2,58
01/01/2015,23,6,11,28,9,7,84
01/02/2015,13,3,8,14,2,2,42
01/03/2015,8,8,5,12,1,2,36
01/04/2015,12,8,5,10,5,2,42
01/05/2015,12,4,7,10,12,5,50
01/06/2015,7,3,4,9,10,1,34
01/07/2015,7,10,5,22,3,2,49
01/08/2015,8,3,2,17,9,7,46
01/09/2015,11,9,2,10,10,4,46
01/10/2015,16,9,7,21,7,8,68
01/11/2015,12,9,4,15,6,3,49
01/12/2015,14,4,6,5,8,2,39
01/13/2015,9,3,3,17,8,4,44
01/14/2015,13,6,1,14,9,1,44
01/15/2015,22,7,5,22,7,4,67
01/16/2015,14,5,7,15,8,1,50
01/17/2015,18,9,7,13,2,4,53
01/18/2015,17,9,5,15,7,2,55
01/19/2015,11,10,3,12,5,3,44
01/20/2015,8,9,1,8,8,6,40
01/21/2015,11,4,8,9,8,1,41
01/22/2015,17,3,6,12,5,0,43
01/23/2015,18,10,4,16,7,9,64
01/24/2015,21,9,6,14,3,7,60
01/25/2015,14,12,7,11,7,10,61
01/26/2015,15,6,1,9,12,3,46
01/27/2015,14,6,1,10,3,2,36
01/28/2015,15,7,4,12,6,3,47
01/29/2015,11,4,6,11,4,3,39
01/30/2015,12,5,6,12,2,1,38
01/31/2015,10,7,5,23,6,4,55
02/01/2015,17,13,7,15,7,3,62
02/02/2015,11,4,4,22,10,5,56
02/03/2015,14,7,3,14,10,0,48
02/04/2015,11,8,6,20,9,3,57
02/05/2015,11,8,5,17,10,3,54
02/06/2015,10,10,4,14,3,3,44
02/07/2015,11,9,3,12,4,2,41
02/08/2015,14,5,6,19,6,2,52
02/09/2015,9,3,5,14,9,3,43
02/10/2015,9,6,1,14,7,4,41
02/11/2015,10,9,8,16,4,1,48
02/12/2015,9,11,5,13,4,4,46
02/13/2015,12,8,9,13,5,1,48
02/14/2015,18,11,7,21,13,4,74
02/15/2015,19,8,4,12,7,5,55
02/16/2015,14,3,3,17,5,1,43
02/17/2015,6,4,7,14,8,6,45
02/18/2015,17,1,4,11,10,5,48
02/19/2015,18,3,7,10,8,3,49
02/20/2015,15,3,4,8,13,2,45
02/21/2015,18,7,6,14,12,1,58
02/22/2015,8,5,4,14,3,1,35
02/23/2015,11,5,3,8,6,2,35
02/24/2015,12,3,0,11,7,2,35
02/25/2015,8,6,2,15,5,3,39
02/26/2015,9,8,5,13,5,2,42
02/27/2015,19,2,5,16,4,4,50
02/28/2015,17,6,7,14,10,2,56
03/01/2015,19,8,9,5,7,2,50
03/02/2015,15,2,3,20,6,3,49
03/03/2015,18,2,8,16,9,7,60
03/04/2015,12,7,9,11,6,1,46
03/05/2015,6,0,7,17,9,3,42
03/06/2015,12,5,11,16,7,3,54
03/07/2015,11,7,7,19,6,2,52
03/08/2015,10,12,7,21,7,2,59
03/09/2015,17,4,8,20,7,2,58
03/10/2015,12,6,6,20,6,3,53
03/11/2015,16,8,7,12,5,1,49
03/12/2015,16,6,4,5,11,4,46
03/13/2015,23,2,7,11,3,2,48
03/14/2015,15,4,2,11,9,3,44
03/15/2015,15,10,4,9,5,2,45
03/16/2015,8,5,3,16,9,4,45
03/17/2015,10,6,4,7,6,3,36
03/18/2015,3,8,5,10,7,3,36
03/19/2015,10,2,8,9,9,3,41
03/20/2015,12,4,8,14,5,4,47
03/21/2015,19,6,6,15,9,3,58
03/22/2015,19,7,4,11,5,2,48
03/23/2015,15,5,3,12,9,2,46
03/24/2015,13,4,10,11,12,4,54
03/25/2015,4,1,4,6,6,5,26
03/26/2015,11,6,2,16,8,4,47
03/27/2015,11,1,2,12,6,2,34
03/28/2015,12,6,6,17,8,5,54
03/29/2015,8,10,2,13,9,2,44
03/30/2015,11,6,4,6,8,4,39
03/31/2015,22,5,5,14,9,3,58
04/01/2015,11,8,2,13,7,5,46
04/02/2015,8,8,5,12,6,6,45
04/03/2015,11,6,6,17,9,1,50
04/04/2015,15,6,7,18,8,1,55
04/05/2015,18,5,8,17,12,1,61
04/06/2015,4,1,5,20,4,5,39
04/07/2015,10,13,6,15,6,2,52
04/08/2015,17,2,7,20,6,2,54
04/09/2015,12,3,5,15,4,2,41
04/10/2015,10,4,7,24,4,0,49
04/11/2015,15,6,9,23,6,4,63
04/12/2015,26,6,7,21,14,4,78
04/13/2015,19,6,4,29,12,4,74
04/14/2015,16,9,11,21,4,3,64
04/15/2015,17,3,8,13,6,6,53
04/16/2015,20,6,4,17,10,1,58
04/17/2015,11,6,5,9,10,5,46
04/18/2015,11,15,4,14,3,8,55
04/19/2015,9,6,5,5,3,4,32
04/20/2015,11,1,1,17,12,4,46
04/21/2015,13,3,4,8,7,1,36
04/22/2015,11,6,0,14,7,3,41
04/23/2015,11,3,6,11,6,1,38
04/24/2015,15,5,2,10,7,5,44
04/25/2015,13,4,6,7,9,5,44
04/26/2015,11,5,4,11,9,7,47
04/27/2015,13,6,3,21,4,4,51
04/28/2015,9,8,5,18,8,1,49
04/29/2015,12,3,2,16,6,5,44
04/30/2015,16,5,6,8,9,3,47
05/01/2015,20,11,4,13,13,3,64
05/02/2015,11,7,9,10,9,4,50
05/03/2015,16,13,7,9,6,2,53
05/04/2015,13,5,6,12,8,3,47
05/05/2015,9,3,4,10,9,5,40
05/06/2015,12,2,2,12,7,1,36
05/07/2015,16,2,3,9,8,6,44
05/08/2015,15,9,4,10,2,5,45
05/09/2015,10,4,2,15,9,4,44
05/10/2015,16,4,3,9,12,1,45
05/11/2015,8,8,3,11,6,4,40
05/12/2015,20,7,3,9,3,2,44
05/13/2015,7,1,3,6,4,3,24
05/14/2015,16,6,3,12,11,0,48
05/15/2015,12,4,3,5,7,1,32
05/16/2015,12,3,2,11,6,3,37
05/17/2015,9,6,3,17,5,2,42
05/18/2015,12,6,6,10,5,2,41
05/19/2015,7,3,2,9,7,6,34
05/20/2015,10,4,2,6,2,2,26
05/21/2015,15,4,2,11,9,2,43
05/22/2015,15,6,3,8,4,8,44
05/23/2015,10,7,6,13,3,2,41
05/24/2015,10,5,4,13,6,0,38
05/25/2015,11,7,5,17,4,4,48
05/26/2015,14,7,7,14,3,1,46
05/27/2015,10,9,6,7,10,3,45
05/28/2015,8,6,8,9,5,2,38
05/29/2015,15,9,6,6,6,3,45
05/30/2015,17,6,3,30,9,5,70
05/31/2015,12,8,6,8,5,2,41
06/01/2015,9,6,4,11,6,3,39
06/02/2015,4,5,5,10,6,6,36
06/03/2015,9,6,5,9,4,1,34
06/04/2015,14,6,4,14,7,2,47
06/05/2015,5,5,1,9,6,1,27
06/06/2015,15,2,3,17,5,3,45
06/07/2015,11,2,3,6,6,8,36
06/08/2015,14,3,8,12,6,0,43
06/09/2015,11,2,5,13,6,4,41
06/10/2015,13,4,9,13,10,4,53
06/11/2015,7,10,4,7,7,2,37
06/12/2015,9,2,5,16,4,2,38
06/13/2015,19,7,6,18,7,4,61
06/14/2015,17,5,2,26,7,5,62
06/15/2015,8,3,4,14,6,3,38
06/16/2015,12,2,3,9,5,4,35
06/17/2015,14,6,1,13,6,3,43
06/18/2015,12,3,3,12,8,0,38
06/19/2015,8,6,5,9,5,1,34
06/20/2015,11,6,6,11,10,4,48
06/21/2015,18,7,6,13,10,1,55
06/22/2015,12,7,5,18,3,2,47
06/23/2015,5,7,1,17,7,1,38
06/24/2015,10,1,3,14,5,4,37
06/25/2015,9,1,7,9,5,2,33
06/26/2015,11,3,4,15,3,0,36
06/27/2015,18,7,4,11,5,4,49
06/28/2015,15,4,8,17,11,3,58
06/29/2015,10,8,4,12,5,1,40
06/30/2015,9,5,3,18,6,2,43
07/01/2015,7,5,2,13,8,0,35
07/02/2015,9,5,3,16,6,0,39
07/03/2015,11,7,5,10,7,5,45
07/04/2015,14,6,6,14,9,4,53
07/05/2015,21,4,2,19,9,6,61
07/06/2015,14,9,2,11,12,4,52
07/07/2015,14,1,2,13,6,1,37
07/08/2015,5,6,3,11,5,3,33
07/09/2015,10,5,4,8,7,3,37
07/10/2015,10,8,8,13,0,2,41
07/11/2015,10,6,3,11,10,2,42
07/12/2015,11,8,2,10,9,0,40
07/13/2015,11,4,6,7,5,1,34
07/14/2015,12,3,3,15,8,1,42
07/15/2015,9,6,1,19,6,7,48
07/16/2015,11,5,3,3,7,2,31
07/17/2015,15,10,9,9,9,4,56
07/18/2015,8,4,4,12,7,2,37
07/19/2015,13,4,3,7,5,4,36
07/20/2015,13,5,4,12,4,2,40
07/21/2015,15,1,4,12,2,1,35
07/22/2015,5,3,2,8,7,2,27
07/23/2015,6,3,5,7,5,4,30
07/24/2015,15,3,4,14,10,4,50
07/25/2015,20,7,3,11,8,2,51
07/26/2015,13,2,5,9,4,3,36
07/27/2015,9,6,5,10,8,1,39
07/28/2015,11,4,4,6,3,2,30
07/29/2015,15,5,2,17,7,3,49
07/30/2015,9,5,3,7,4,1,29
07/31/2015,11,2,3,7,10,5,38
08/01/2015,8,4,2,13,6,0,33
08/02/2015,19,8,2,11,8,3,51
08/03/2015,3,7,7,8,9,2,36
08/04/2015,6,6,0,7,4,1,24
08/05/2015,8,2,1,11,4,8,34
08/06/2015,10,5,2,7,9,1,34
08/07/2015,23,5,4,13,9,2,56
08/08/2015,12,7,5,8,5,7,44
08/09/2015,5,5,2,11,2,2,27
08/10/2015,6,8,6,10,8,5,43
08/11/2015,16,4,1,10,15,2,48
08/12/2015,11,12,5,9,8,1,46
08/13/2015,16,3,6,8,5,3,41
08/14/2015,9,6,2,13,11,4,45
08/15/2015,13,13,4,16,6,0,52
08/16/2015,13,2,5,12,4,1,37
08/17/2015,11,3,2,16,9,2,43
08/18/2015,10,8,2,11,3,4,38
08/19/2015,10,11,2,11,4,2,40
08/20/2015,12,5,5,5,10,2,39
08/21/2015,7,5,2,4,6,3,27
08/22/2015,17,10,1,11,11,1,51
08/23/2015,7,13,6,11,12,3,52
08/24/2015,8,6,3,8,5,4,34
08/25/2015,22,3,4,10,8,3,50
08/26/2015,8,5,6,3,8,2,32
08/27/2015,10,2,5,10,7,1,35
08/28/2015,9,4,2,9,12,2,38
08/29/2015,10,9,3,15,7,2,46
08/30/2015,9,10,8,7,4,2,40
08/31/2015,13,5,6,6,6,1,37
09/01/2015,12,5,4,7,2,1,31
09/02/2015,14,9,4,7,10,2,46
09/03/2015,18,5,8,15,9,5,60
09/04/2015,7,10,7,5,5,7,41
09/05/2015,20,3,7,16,5,2,53
09/06/2015,13,8,2,7,6,1,37
09/07/2015,12,8,5,10,5,0,40
09/08/2015,13,8,5,13,5,4,48
09/09/2015,9,4,3,12,5,2,35
09/10/2015,12,8,4,8,9,2,43
09/11/2015,10,12,5,16,7,5,55
09/12/2015,12,8,5,10,8,2,45
09/13/2015,16,4,5,9,13,5,52
09/14/2015,6,5,5,7,4,1,28
09/15/2015,5,7,6,5,7,2,32
09/16/2015,12,2,3,11,9,5,42
09/17/2015,4,3,2,10,8,1,28
09/18/2015,11,6,2,10,9,1,39
09/19/2015,8,4,4,9,9,1,35
09/20/2015,13,4,4,11,5,3,40
09/21/2015,13,5,8,8,6,2,42
09/22/2015,12,5,1,11,2,1,32
09/23/2015,13,6,4,6,7,2,38
09/24/2015,11,4,1,14,5,3,38
09/25/2015,9,5,3,13,7,6,43
09/26/2015,13,8,5,14,6,5,51
09/27/2015,15,7,4,14,5,2,47
09/28/2015,18,3,1,15,4,4,45
09/29/2015,14,5,9,13,5,2,48
09/30/2015,14,5,5,13,6,3,46
10/01/2015,15,3,1,13,9,4,45
10/02/2015,16,4,6,12,4,2,44
10/03/2015,14,6,6,6,4,5,41
10/04/2015,14,4,5,12,4,4,43
10/05/2015,12,6,5,14,5,5,47
10/06/2015,9,9,7,13,5,4,47
10/07/2015,11,3,7,9,8,3,41
10/08/2015,11,5,2,18,10,1,47
10/09/2015,17,8,5,13,7,2,52
10/10/2015,11,10,3,12,7,3,46
10/11/2015,8,12,3,7,7,0,37
10/12/2015,7,2,4,7,10,2,32
10/13/2015,10,5,4,10,7,0,36
10/14/2015,11,7,3,14,7,3,45
10/15/2015,9,2,2,13,1,1,28
10/16/2015,15,4,3,16,7,0,45
10/17/2015,17,9,5,8,5,2,46
10/18/2015,16,11,4,12,7,3,53
10/19/2015,16,6,1,9,8,1,41
10/20/2015,10,3,5,12,6,8,44
10/21/2015,11,2,4,7,7,2,33
10/22/2015,12,6,5,16,7,3,49
10/23/2015,8,7,8,20,9,2,54
10/24/2015,12,1,10,22,10,1,56
10/25/2015,13,3,9,23,5,14,67
10/26/2015,21,5,9,18,5,5,63
10/27/2015,16,7,9,19,6,5,62
10/28/2015,15,5,1,17,6,2,46
10/29/2015,10,4,5,14,4,4,41
10/30/2015,10,7,7,20,10,2,56
10/31/2015,14,5,6,8,8,3,44
11/01/2015,12,5,5,21,4,2,49
11/02/2015,19,5,6,15,5,2,52
11/03/2015,14,5,9,16,6,1,51
11/04/2015,13,5,5,13,2,2,40
11/05/2015,11,4,3,20,7,2,47
11/06/2015,16,11,1,26,2,1,57
11/07/2015,19,12,5,18,2,4,60
11/08/2015,16,5,8,13,10,4,56
11/09/2015,7,6,8,17,4,1,43
11/10/2015,14,1,4,11,7,3,40
11/11/2015,18,6,2,16,6,1,49
11/12/2015,13,8,3,18,7,1,50
11/13/2015,13,2,11,11,8,4,49
11/14/2015,13,5,8,13,6,6,51
11/15/2015,26,10,6,15,6,4,67
11/16/2015,15,9,5,12,6,2,49
11/17/2015,16,5,7,9,6,4,47
11/18/2015,16,4,8,17,7,6,58
11/19/2015,19,5,2,10,5,4,45
11/20/2015,15,4,5,16,6,3,49
11/21/2015,15,9,5,21,4,5,59
11/22/2015,15,7,7,20,5,4,58
11/23/2015,15,8,4,23,5,3,58
11/24/2015,18,10,4,17,9,2,60
11/25/2015,15,6,5,17,10,2,55
11/26/2015,21,12,7,24,4,3,71
11/27/2015,12,5,6,16,8,1,48
11/28/2015,20,6,6,21,5,5,63
11/29/2015,21,3,6,20,6,3,59
11/30/2015,17,5,5,25,7,6,65
12/01/2015,14,6,8,20,6,5,59
12/02/2015,13,9,3,16,8,6,55
12/03/2015,14,7,5,18,5,3,52
12/04/2015,11,4,8,21,8,9,61
12/05/2015,9,7,7,22,6,3,54
12/06/2015,17,7,4,19,10,6,63
12/07/2015,11,7,2,14,8,3,45
12/08/2015,19,9,6,18,3,7,62
12/09/2015,17,6,4,16,7,2,52
12/10/2015,7,5,4,10,10,3,39
12/11/2015,12,5,10,15,3,4,49
12/12/2015,18,4,8,27,5,6,68
12/13/2015,14,2,8,19,8,6,57
12/14/2015,9,5,3,13,6,6,42
12/15/2015,16,4,7,25,13,5,70
12/16/2015,14,8,10,13,6,3,54
12/17/2015,11,11,5,16,8,2,53
12/18/2015,9,13,2,19,8,4,55
12/19/2015,12,5,5,15,7,1,45
12/20/2015,15,14,9,20,10,5,73
12/21/2015,9,7,2,13,5,5,41
12/22/2015,17,8,7,22,8,4,66
12/23/2015,18,2,8,19,6,5,58
12/24/2015,11,4,5,18,10,4,52
12/25/2015,18,11,6,24,3,1,63
12/26/2015,23,10,10,20,3,5,71
12/27/2015,12,7,1,14,3,0,37
12/28/2015,16,3,2,18,2,2,43
12/29/2015,18,4,5,11,4,4,46
12/30/2015,14,8,3,16,3,7,51
12/31/2015,10,1,4,18,2,1,36
01/01/2016,27,11,5,40,9,5,97
01/02/2016,14,7,4,22,7,2,56
01/03/2016,13,6,6,20,5,6,56
01/04/2016,14,5,1,24,5,5,54
01/05/2016,17,3,2,11,7,5,45
01/06/2016,18,2,3,15,12,2,52
01/07/2016,8,12,4,14,2,0,40
01/08/2016,13,4,5,15,8,8,53
01/09/2016,16,8,4,19,8,3,58
01/10/2016,10,7,7,15,7,6,52
01/11/2016,15,11,7,7,8,2,50
01/12/2016,14,4,9,19,5,5,56
01/13/2016,14,9,2,18,7,1,51
01/14/2016,14,10,6,15,3,4,52
01/15/2016,7,15,3,13,8,2,48
01/16/2016,21,10,3,16,5,4,59
01/17/2016,18,7,7,20,14,3,69
01/18/2016,19,7,7,13,2,2,50
01/19/2016,10,5,5,8,6,4,38
01/20/2016,16,7,10,16,7,0,56
01/21/2016,14,4,9,15,8,3,53
01/22/2016,17,10,6,14,6,4,57
01/23/2016,20,9,14,16,11,4,74
01/24/2016,13,11,8,14,10,4,60
01/25/2016,12,5,3,11,12,6,49
01/26/2016,13,7,8,12,5,0,45
01/27/2016,12,8,4,15,9,2,50
01/28/2016,14,6,10,9,5,3,47
01/29/2016,15,8,2,16,4,4,49
01/30/2016,26,9,5,23,6,6,75
01/31/2016,18,11,9,18,5,0,61
02/01/2016,6,7,5,24,13,1,56
02/02/2016,15,3,2,11,7,4,42
02/03/2016,11,6,10,32,6,2,67
02/04/2016,21,7,4,16,14,0,62
02/05/2016,26,4,10,11,8,3,62
02/06/2016,11,8,9,23,13,3,67
02/07/2016,20,11,7,18,12,5,73
02/08/2016,22,2,4,14,4,5,51
02/09/2016,17,7,6,12,9,6,57
02/10/2016,13,6,13,13,7,4,56
02/11/2016,19,9,2,18,5,1,54
02/12/2016,14,2,3,13,9,3,44
02/13/2016,20,6,10,18,6,3,63
02/14/2016,24,14,5,27,10,4,84
02/15/2016,20,5,6,24,11,0,66
02/16/2016,17,11,4,15,4,4,55
02/17/2016,16,4,6,17,4,1,48
02/18/2016,14,5,8,12,7,2,48
02/19/2016,14,11,5,16,11,5,62
02/20/2016,27,10,10,15,9,12,83
02/21/2016,15,9,8,11,4,0,47
02/22/2016,12,10,4,14,7,2,49
02/23/2016,15,8,10,19,7,1,60
02/24/2016,13,8,5,9,3,9,47
02/25/2016,19,4,9,12,9,5,58
02/26/2016,14,5,4,12,13,6,54
02/27/2016,20,5,9,17,13,2,66
02/28/2016,12,15,3,17,11,4,62
03/01/2016,14,12,4,11,13,6,60
03/02/2016,26,4,6,17,6,2,61
03/03/2016,12,5,2,16,10,2,47
03/04/2016,15,7,10,22,10,1,65
03/05/2016,12,12,7,17,12,1,61
03/06/2016,19,5,7,27,11,5,74
03/07/2016,15,5,5,16,7,4,52
03/08/2016,12,5,5,14,6,4,46
03/09/2016,12,5,5,19,9,2,52
03/10/2016,15,9,7,6,6,3,46
03/11/2016,13,2,7,8,6,5,41
03/12/2016,14,11,4,24,12,6,71
03/13/2016,22,16,6,29,6,1,80
03/14/2016,18,6,3,21,10,2,60
03/15/2016,12,10,11,18,5,3,59
03/16/2016,11,6,5,11,5,3,41
03/17/2016,15,6,5,25,12,2,65
03/18/2016,16,7,8,16,16,2,65
03/19/2016,17,11,7,21,13,4,73
03/20/2016,14,9,8,12,8,3,54
03/21/2016,16,6,3,22,3,3,53
03/22/2016,13,3,7,22,11,7,63
03/23/2016,7,6,6,15,8,6,48
03/24/2016,14,8,3,15,4,5,49
03/25/2016,14,5,5,10,5,9,48
03/26/2016,22,7,7,14,10,3,63
03/27/2016,15,5,7,18,5,5,55
03/28/2016,12,3,8,15,9,4,51
03/29/2016,13,10,7,10,4,2,46
03/30/2016,15,4,4,10,7,0,40
03/31/2016,16,5,6,18,13,1,59
04/01/2016,16,8,13,14,5,2,58
04/02/2016,12,8,4,22,11,1,58
04/03/2016,21,6,3,12,12,1,55
04/04/2016,15,9,5,18,13,3,63
04/05/2016,10,7,5,22,3,5,52
04/06/2016,16,5,5,9,5,4,44
04/07/2016,13,12,4,10,5,1,45
04/08/2016,13,4,6,17,5,2,47
04/09/2016,17,9,6,21,3,5,61
04/10/2016,30,6,6,18,4,1,65
04/11/2016,13,9,3,31,2,5,63
04/12/2016,26,6,11,27,10,7,87
04/13/2016,24,2,10,36,12,4,88
04/14/2016,34,1,17,20,5,3,80
04/15/2016,19,8,6,34,10,11,88
04/16/2016,19,8,6,22,6,6,67
04/17/2016,19,2,5,11,7,5,49
04/18/2016,11,7,6,14,14,4,56
04/19/2016,19,9,6,17,6,2,59
04/20/2016,13,4,4,15,9,2,47
04/21/2016,9,5,0,9,5,1,29
04/22/2016,17,3,1,10,6,7,44
04/23/2016,13,2,4,8,7,7,41
04/24/2016,16,7,3,10,9,4,49
04/25/2016,13,4,9,10,10,1,47
04/26/2016,17,7,3,15,6,6,54
04/27/2016,11,4,3,9,24,1,52
04/28/2016,14,10,5,10,4,3,46
04/29/2016,10,8,7,13,3,1,42
04/30/2016,16,9,7,16,14,5,67
05/01/2016,9,8,3,12,8,2,42
05/02/2016,5,5,1,12,8,4,35
05/03/2016,14,8,6,12,11,2,53
05/04/2016,12,3,3,11,7,2,38
05/05/2016,14,3,3,14,5,5,44
05/06/2016,17,6,4,11,8,6,52
05/07/2016,18,7,5,17,7,2,56
05/08/2016,17,6,8,15,3,1,50
05/09/2016,11,5,3,15,1,4,39
05/10/2016,8,9,4,8,9,0,38
05/11/2016,12,5,6,11,7,4,45
05/12/2016,17,8,6,12,6,2,51
05/13/2016,9,9,4,11,5,10,48
05/14/2016,20,7,7,13,9,9,65
05/15/2016,13,6,3,12,10,2,46
05/16/2016,19,8,7,12,13,1,60
05/17/2016,11,3,3,17,4,7,45
05/18/2016,18,5,7,17,3,3,53
05/19/2016,9,3,6,16,5,1,40
05/20/2016,7,8,5,8,8,5,41
05/21/2016,9,9,4,19,2,1,44
05/22/2016,14,13,4,15,7,0,53
05/23/2016,8,8,0,11,4,9,40
05/24/2016,13,5,2,17,4,1,42
05/25/2016,12,1,6,6,4,3,32
05/26/2016,7,10,11,17,5,0,50
05/27/2016,14,5,3,16,4,1,43
05/28/2016,17,12,6,14,9,2,60
05/29/2016,16,3,6,11,7,1,44
05/30/2016,16,8,4,11,9,5,53
05/31/2016,11,9,2,18,3,4,47
06/01/2016,11,4,4,14,8,2,43
06/02/2016,18,14,2,15,4,3,56
06/03/2016,17,11,5,11,12,4,60
06/04/2016,15,11,2,23,7,3,61
06/05/2016,7,5,8,12,7,2,41
06/06/2016,11,5,12,13,3,2,46
06/07/2016,10,12,8,10,9,2,51
06/08/2016,15,9,4,16,8,2,54
06/09/2016,16,5,5,9,5,6,46
06/10/2016,14,19,8,12,13,3,69
06/11/2016,14,7,4,11,8,3,47
06/12/2016,7,6,7,13,5,5,43
06/13/2016,17,11,7,9,4,3,51
06/14/2016,5,5,5,17,4,4,40
06/15/2016,9,8,4,11,3,5,40
06/16/2016,13,6,5,12,6,1,43
06/17/2016,13,4,7,15,5,4,48
06/18/2016,16,3,11,14,5,4,53
06/19/2016,12,8,8,17,6,1,52
06/20/2016,14,5,8,12,12,5,56
06/21/2016,12,6,6,19,2,0,45
06/22/2016,17,11,6,13,10,0,57
06/23/2016,13,4,7,10,12,4,50
06/24/2016,17,5,5,19,4,2,52
06/25/2016,11,5,10,14,10,4,54
06/26/2016,9,11,6,15,5,0,46
06/27/2016,14,5,5,12,7,2,45
06/28/2016,9,2,3,9,7,1,31
06/29/2016,19,1,4,10,3,2,39
06/30/2016,11,9,8,23,9,1,61
07/01/2016,14,9,3,16,9,2,53
07/02/2016,26,7,7,15,8,2,65
07/03/2016,12,7,4,9,7,4,43
07/04/2016,16,4,6,18,4,7,55
07/05/2016,15,4,1,9,4,1,34
07/06/2016,13,6,2,7,11,2,41
07/07/2016,13,6,1,8,14,3,45
07/08/2016,19,8,6,19,12,3,67
07/09/2016,11,11,4,11,6,4,47
07/10/2016,15,9,6,12,7,4,53
07/11/2016,9,6,4,10,7,2,38
07/12/2016,14,4,3,11,6,2,40
07/13/2016,7,5,3,8,8,3,34
07/14/2016,21,7,8,16,9,4,65
07/15/2016,11,7,6,19,3,3,49
07/16/2016,17,9,4,13,2,1,46
07/17/2016,17,9,5,16,12,6,65
07/18/2016,21,8,9,17,4,2,61
07/19/2016,11,9,5,13,6,1,45
07/20/2016,14,2,0,18,4,3,41
07/21/2016,8,2,2,11,5,1,29
07/22/2016,23,5,6,11,8,6,59
07/23/2016,18,1,7,18,5,7,56
07/24/2016,24,4,0,11,6,3,48
07/25/2016,19,7,4,8,7,1,46
07/26/2016,16,5,4,15,4,2,46
07/27/2016,10,9,2,12,6,2,41
07/28/2016,13,5,4,11,4,3,40
07/29/2016,14,4,0,9,8,4,39
07/30/2016,15,6,4,13,10,3,51
07/31/2016,15,9,6,15,4,7,56
08/01/2016,10,8,0,8,20,7,53
08/02/2016,10,5,7,8,7,2,39
08/03/2016,12,5,4,11,7,5,44
08/04/2016,7,9,3,8,9,2,38
08/05/2016,9,8,6,19,5,0,47
08/06/2016,16,9,6,11,8,2,52
08/07/2016,18,5,3,20,1,3,50
08/08/2016,15,2,5,14,7,2,45
08/09/2016,12,4,4,11,8,2,41
08/10/2016,4,2,4,12,6,4,32
08/11/2016,11,6,3,15,8,1,44
08/12/2016,11,5,3,16,5,5,45
08/13/2016,14,2,5,16,10,6,53
08/14/2016,15,10,1,13,8,3,50
08/15/2016,9,8,2,16,7,2,44
08/16/2016,10,8,2,15,5,2,42
08/17/2016,15,5,4,9,5,1,39
08/18/2016,9,5,9,11,5,2,41
08/19/2016,14,5,6,15,8,1,49
08/20/2016,16,7,2,14,6,4,49
08/21/2016,12,2,7,13,9,0,43
08/22/2016,16,7,3,12,3,1,42
08/23/2016,8,7,3,9,10,7,44
08/24/2016,10,7,3,11,5,2,38
08/25/2016,13,11,1,17,9,3,54
08/26/2016,13,5,3,17,6,9,53
08/27/2016,21,10,2,11,7,2,53
08/28/2016,14,7,12,15,10,1,59
08/29/2016,14,5,4,6,8,1,38
08/30/2016,7,7,4,9,0,2,29
08/31/2016,8,7,6,10,7,2,40
09/01/2016,10,6,6,11,9,3,45
09/02/2016,13,8,4,17,8,4,54
09/03/2016,17,11,8,13,10,3,62
09/04/2016,14,6,3,19,7,5,54
09/05/2016,12,8,3,7,9,2,41
09/06/2016,19,3,8,11,2,4,47
09/07/2016,16,3,1,18,4,6,48
09/08/2016,17,5,7,16,4,2,51
09/09/2016,15,8,2,9,6,3,43
09/10/2016,13,10,4,8,6,5,46
09/11/2016,13,6,8,24,8,3,62
09/12/2016,11,3,8,9,10,1,42
09/13/2016,13,3,9,10,7,3,45
09/14/2016,12,6,4,8,5,1,36
09/15/2016,12,6,2,4,8,2,34
09/16/2016,19,9,3,11,7,1,50
09/17/2016,19,9,7,16,6,5,62
09/18/2016,9,7,6,18,9,2,51
09/19/2016,10,4,5,16,20,1,56
09/20/2016,17,5,5,9,9,1,46
09/21/2016,17,2,1,4,5,3,32
09/22/2016,8,4,2,2,7,4,27
09/23/2016,19,5,2,9,5,2,42
09/24/2016,13,12,6,17,6,8,62
09/25/2016,22,6,1,19,12,9,69
09/26/2016,14,7,4,13,5,7,50
09/27/2016,13,4,3,15,5,0,40
09/28/2016,13,1,7,16,6,1,44
09/29/2016,16,3,8,9,8,1,45
09/30/2016,18,6,3,17,10,1,55
10/01/2016,19,7,6,8,7,6,53
10/02/2016,9,6,9,20,8,5,57
10/03/2016,16,2,6,20,3,2,49
10/04/2016,12,1,7,11,4,2,37
10/05/2016,12,3,10,13,4,3,45
10/06/2016,13,5,8,23,9,4,62
10/07/2016,17,8,7,12,7,4,55
10/08/2016,14,14,19,14,5,5,71
10/09/2016,19,6,4,11,3,3,46
10/10/2016,13,5,1,14,7,3,43
10/11/2016,10,7,4,15,9,2,47
10/12/2016,20,6,7,18,10,3,64
10/13/2016,12,4,4,15,4,3,42
10/14/2016,11,2,8,12,3,0,36
10/15/2016,13,6,4,11,3,1,38
10/16/2016,13,5,5,20,4,2,49
10/17/2016,11,3,4,22,6,5,51
10/18/2016,11,9,4,14,10,1,49
10/19/2016,9,9,3,19,2,1,43
10/20/2016,14,9,7,18,3,1,52
10/21/2016,11,4,8,11,7,4,45
10/22/2016,13,10,6,16,4,1,50
10/23/2016,14,10,8,13,5,7,57
10/24/2016,12,2,6,25,2,2,49
10/25/2016,12,5,6,13,6,2,44
10/26/2016,14,5,5,16,4,3,47
10/27/2016,15,8,4,5,1,5,38
10/28/2016,20,10,5,11,6,0,52
10/29/2016,15,5,4,14,2,3,43
10/30/2016,17,2,8,17,14,7,65
10/31/2016,14,8,7,20,8,7,64
11/01/2016,17,3,9,10,6,4,49
11/02/2016,16,7,4,9,8,4,48
11/03/2016,15,6,6,13,3,3,46
11/04/2016,16,3,3,17,4,1,44
11/05/2016,20,10,8,21,5,5,69
11/06/2016,20,7,8,10,10,1,56
11/07/2016,19,1,7,10,5,5,47
11/08/2016,12,3,7,17,12,2,53
11/09/2016,7,7,5,18,6,2,45
11/10/2016,8,2,7,14,6,3,40
11/11/2016,17,5,5,25,9,3,64
11/12/2016,15,7,8,22,5,4,61
11/13/2016,20,8,5,20,4,5,62
11/14/2016,16,11,5,16,5,3,56
11/15/2016,17,10,9,16,5,4,61
11/16/2016,15,3,6,23,6,4,57
11/17/2016,22,8,8,11,6,3,58
11/18/2016,17,5,7,15,11,2,57
11/19/2016,23,11,3,21,11,2,71
11/20/2016,19,5,7,13,3,1,48
11/21/2016,11,4,9,19,6,1,50
11/22/2016,11,7,3,14,8,2,45
11/23/2016,17,6,4,15,8,4,54
11/24/2016,13,8,4,19,9,2,55
11/25/2016,12,8,7,15,6,5,53
11/26/2016,18,11,4,15,5,3,56
11/27/2016,23,10,10,20,10,8,81
11/28/2016,12,6,3,23,2,4,50
11/29/2016,13,5,6,14,11,5,54
11/30/2016,17,5,2,14,6,2,46
12/01/2016,12,9,5,11,9,1,47
12/02/2016,14,6,1,19,8,5,53
12/03/2016,18,5,10,20,3,5,61
12/04/2016,20,4,3,22,3,8,60
12/05/2016,23,11,10,19,6,6,75
12/06/2016,18,2,6,18,6,3,53
12/07/2016,20,8,5,17,5,1,56
12/08/2016,13,4,5,18,1,1,42
12/09/2016,12,7,2,12,4,5,42
12/10/2016,10,9,4,27,10,4,64
12/11/2016,11,8,6,21,11,4,61
12/12/2016,16,9,9,17,6,5,62
12/13/2016,12,13,4,18,6,4,57
12/14/2016,20,6,6,16,4,3,55
12/15/2016,21,2,7,25,3,2,60
12/16/2016,12,5,8,25,12,1,63
12/17/2016,14,7,9,22,6,1,59
12/18/2016,22,6,7,19,6,2,62
12/19/2016,19,5,4,20,11,8,67
12/20/2016,20,5,3,20,9,4,61
12/21/2016,11,9,4,17,7,2,50
12/22/2016,14,6,8,18,3,3,52
12/23/2016,16,14,2,22,1,0,55
12/24/2016,23,5,6,19,8,2,63
12/25/2016,14,8,6,11,6,3,48
12/26/2016,21,9,5,21,5,2,63
12/27/2016,16,4,5,16,3,6,50
12/28/2016,14,9,5,27,5,4,64
12/29/2016,18,6,6,21,7,3,61
12/30/2016,17,6,9,27,6,0,65
12/31/2016,12,11,3,22,7,3,58
01/01/2017,21,7,10,45,17,5,105
01/02/2017,19,24,5,26,4,1,79
01/03/2017,14,15,2,26,7,3,67
01/04/2017,25,6,3,17,6,3,60
01/05/2017,11,3,4,21,7,2,48
01/06/2017,11,8,1,22,6,3,51
01/07/2017,13,7,3,23,5,2,53
01/08/2017,25,8,4,21,5,3,66
01/09/2017,9,11,7,19,4,4,54
01/10/2017,15,4,7,13,4,2,45
01/11/2017,15,8,6,15,8,3,55
01/12/2017,21,6,5,11,4,3,50
01/13/2017,17,9,7,11,13,1,58
01/14/2017,17,6,6,20,4,6,59
01/15/2017,25,10,4,19,11,3,72
01/16/2017,11,7,2,10,10,1,41
01/17/2017,11,4,2,20,10,3,50
01/18/2017,19,4,3,15,8,2,51
01/19/2017,15,13,5,12,13,5,63
01/20/2017,20,6,3,15,8,5,57
01/21/2017,7,6,4,28,4,6,55
01/22/2017,21,10,9,20,3,2,65
01/23/2017,14,6,10,14,8,7,59
01/24/2017,15,10,4,9,7,2,47
01/25/2017,9,9,2,12,2,2,36
01/26/2017,13,13,10,18,7,0,61
01/27/2017,18,4,8,13,4,4,51
01/28/2017,16,6,6,24,7,5,64
01/29/2017,18,7,8,20,6,2,61
01/30/2017,19,6,5,27,7,1,65
01/31/2017,15,5,5,19,4,4,52
02/01/2017,23,8,6,22,6,3,68
02/02/2017,10,7,6,29,8,2,62
02/03/2017,19,7,4,19,7,3,59
02/04/2017,21,10,6,20,9,7,73
02/05/2017,12,2,1,25,10,5,55
02/06/2017,15,7,7,16,5,3,53
02/07/2017,25,7,4,19,6,3,64
02/08/2017,11,3,4,9,4,4,35
02/09/2017,23,5,8,15,9,8,68
02/10/2017,25,7,5,15,9,4,65
02/11/2017,10,9,6,21,8,4,58
02/12/2017,9,9,2,20,2,1,43
02/13/2017,6,7,9,18,15,5,60
02/14/2017,15,4,5,9,5,4,42
02/15/2017,12,8,10,12,14,5,61
02/16/2017,15,7,3,18,8,1,52
02/17/2017,26,8,11,17,8,4,74
02/18/2017,20,5,3,20,9,5,62
02/19/2017,17,16,7,27,10,6,83
02/20/2017,13,4,3,21,10,3,54
02/21/2017,7,11,4,10,7,2,41
02/22/2017,21,5,6,6,7,2,47
02/23/2017,20,9,7,23,7,4,70
02/24/2017,26,5,10,19,4,2,66
02/25/2017,20,11,8,17,7,3,66
02/26/2017,20,7,8,15,8,4,62
02/27/2017,15,3,11,14,8,5,56
02/28/2017,12,7,7,13,6,3,48
03/01/2017,19,8,8,22,7,3,67
03/02/2017,24,9,8,9,14,6,70
03/03/2017,23,4,7,16,9,2,61
03/04/2017,28,7,8,26,7,4,80
03/05/2017,24,12,4,20,12,3,75
03/06/2017,14,12,4,25,9,4,68
03/07/2017,16,6,3,22,10,2,59
03/08/2017,15,6,4,25,10,1,61
03/09/2017,16,12,5,29,7,3,72
03/10/2017,15,6,3,18,9,7,58
03/11/2017,18,8,2,28,5,1,62
03/12/2017,18,9,4,25,7,5,68
03/13/2017,18,4,9,16,2,8,57
03/14/2017,20,9,12,12,8,5,66
03/15/2017,8,9,3,15,12,7,54
03/16/2017,16,4,6,18,7,9,60
03/17/2017,17,9,4,20,9,2,61
03/18/2017,17,4,3,16,7,6,53
03/19/2017,10,10,8,9,6,1,44
03/20/2017,9,5,3,14,10,3,44
03/21/2017,15,8,5,15,4,0,47
03/22/2017,14,3,6,14,5,2,44
03/23/2017,12,5,4,22,8,7,58
03/24/2017,16,7,9,16,8,3,59
03/25/2017,20,2,15,22,9,4,72
03/26/2017,18,10,6,14,6,6,60
03/27/2017,18,6,8,14,8,4,58
03/28/2017,11,5,5,10,6,3,40
03/29/2017,14,3,2,20,4,5,48
03/30/2017,19,6,9,11,4,3,52
03/31/2017,17,3,6,14,4,5,49
04/01/2017,20,9,10,19,10,7,75
04/02/2017,13,5,4,14,7,6,49
04/03/2017,17,6,4,13,8,7,55
04/04/2017,13,7,1,21,5,2,49
04/05/2017,14,8,4,20,5,2,53
04/06/2017,21,5,3,17,4,1,51
04/07/2017,20,6,6,19,3,3,57
04/08/2017,18,6,6,15,8,2,55
04/09/2017,16,8,9,19,8,4,64
04/10/2017,16,3,12,33,7,4,75
04/11/2017,12,6,7,19,6,2,52
04/12/2017,14,3,7,24,8,8,64
04/13/2017,28,5,9,38,6,3,89
04/14/2017,27,7,6,26,5,7,78
04/15/2017,17,4,14,22,7,3,67
04/16/2017,25,9,9,8,9,0,60
04/17/2017,14,4,4,16,11,4,53
04/18/2017,11,7,4,12,5,2,41
04/19/2017,14,7,4,15,6,0,46
04/20/2017,11,4,6,17,7,6,51
04/21/2017,14,4,5,10,5,1,39
04/22/2017,5,5,3,12,11,2,38
04/23/2017,10,9,9,13,7,4,52
04/24/2017,8,1,7,13,9,8,46
04/25/2017,14,6,4,8,3,1,36
04/26/2017,10,3,4,6,8,3,34
04/27/2017,16,5,7,19,9,5,61
04/28/2017,16,6,1,14,9,2,48
04/29/2017,5,7,3,7,13,3,38
04/30/2017,5,11,5,16,5,5,47
05/01/2017,14,10,6,18,13,2,63
05/02/2017,17,9,3,16,8,1,54
05/03/2017,14,2,4,19,9,3,51
05/04/2017,13,8,5,14,11,3,54
05/05/2017,27,7,7,14,9,2,66
05/06/2017,11,5,6,23,7,3,55
05/07/2017,15,5,7,19,14,1,61
05/08/2017,12,5,3,27,6,11,64
05/09/2017,11,7,3,11,6,5,43
05/10/2017,13,6,8,14,10,6,57
05/11/2017,12,6,3,10,8,1,40
05/12/2017,8,5,0,14,5,6,38
05/13/2017,19,4,4,8,6,4,45
05/14/2017,11,4,4,18,3,2,42
05/15/2017,15,3,4,9,8,2,41
05/16/2017,14,2,7,11,4,4,42
05/17/2017,10,4,1,5,4,3,27
05/18/2017,8,5,3,9,4,1,30
05/19/2017,16,4,3,18,9,4,54
05/20/2017,6,9,0,13,6,1,35
05/21/2017,9,5,4,12,9,6,45
05/22/2017,12,9,5,11,6,4,47
05/23/2017,14,4,5,14,10,5,52
05/24/2017,9,3,4,9,6,3,34
05/25/2017,15,6,0,8,6,4,39
05/26/2017,10,13,5,17,7,3,55
05/27/2017,15,8,6,20,17,5,71
05/28/2017,25,7,4,11,6,2,55
05/29/2017,11,3,7,6,5,4,36
05/30/2017,13,3,5,14,6,2,43
05/31/2017,10,9,2,9,4,2,36
06/01/2017,13,4,7,14,10,3,51
06/02/2017,12,9,4,13,4,6,48
06/03/2017,12,11,6,17,7,5,58
06/04/2017,10,11,3,18,7,3,52
06/05/2017,19,6,1,21,7,5,59
06/06/2017,17,7,3,16,8,6,57
06/07/2017,18,13,5,8,9,1,54
06/08/2017,8,10,6,14,6,1,45
06/09/2017,13,6,7,10,9,4,49
06/10/2017,16,6,4,13,8,7,54
06/11/2017,16,5,5,15,14,2,57
06/12/2017,7,5,7,12,11,4,46
06/13/2017,21,7,4,15,9,3,59
06/14/2017,11,5,2,16,3,1,38
06/15/2017,13,7,1,13,9,3,46
06/16/2017,14,10,3,13,6,0,46
06/17/2017,16,5,4,15,8,1,49
06/18/2017,11,3,7,22,9,5,57
06/19/2017,16,7,5,15,6,4,53
06/20/2017,13,8,4,19,5,2,51
06/21/2017,14,7,2,16,7,2,48
06/22/2017,10,7,6,14,7,1,45
06/23/2017,17,6,7,15,5,2,52
06/24/2017,12,8,6,19,8,4,57
06/25/2017,15,3,1,13,9,2,43
06/26/2017,22,5,8,21,7,3,66
06/27/2017,11,5,5,15,6,2,44
06/28/2017,16,8,6,13,5,4,52
06/29/2017,12,1,5,12,7,2,39
06/30/2017,16,7,6,10,12,4,55
07/01/2017,15,5,5,19,7,2,53
07/02/2017,19,11,7,15,5,5,62
07/03/2017,11,6,2,12,10,5,46
07/04/2017,5,7,3,13,11,1,40
07/05/2017,12,4,2,18,8,3,47
07/06/2017,13,2,4,19,6,4,48
07/07/2017,6,6,7,19,8,3,49
07/08/2017,12,4,4,18,5,2,45
07/09/2017,10,3,4,11,9,4,41
07/10/2017,10,4,5,6,5,2,32
07/11/2017,6,6,4,8,7,2,33
07/12/2017,11,2,4,21,6,0,44
07/13/2017,6,8,2,19,9,3,47
07/14/2017,11,3,2,11,6,1,34
07/15/2017,6,6,6,15,6,2,41
07/16/2017,12,4,1,8,16,3,44
07/17/2017,6,5,1,8,5,2,27
07/18/2017,9,4,5,9,9,7,43
07/19/2017,7,5,2,10,7,3,34
07/20/2017,6,5,5,19,6,4,45
07/21/2017,7,3,4,16,8,1,39
07/22/2017,11,8,4,20,7,1,51
07/23/2017,17,5,2,10,3,2,39
07/24/2017,11,3,3,17,6,3,43
07/25/2017,10,7,2,14,8,2,43
07/26/2017,19,8,8,11,5,2,53
07/27/2017,10,2,3,20,12,1,48
07/28/2017,10,8,2,9,11,5,45
07/29/2017,13,5,1,6,8,2,35
07/30/2017,11,5,5,14,9,4,48
07/31/2017,17,6,3,10,7,0,43
08/01/2017,11,9,6,12,10,0,48
08/02/2017,12,9,2,11,9,4,47
08/03/2017,13,6,5,19,12,2,57
08/04/2017,10,5,2,15,9,4,45
08/05/2017,11,4,3,12,2,3,35
08/06/2017,16,7,9,13,4,1,50
08/07/2017,14,8,4,10,5,2,43
08/08/2017,6,4,3,7,3,1,24
08/09/2017,6,5,3,11,6,1,32
08/10/2017,9,7,4,7,5,3,35
08/11/2017,14,4,0,13,12,2,45
08/12/2017,13,8,4,23,9,8,65
08/13/2017,15,4,2,27,3,3,54
08/14/2017,6,3,2,24,8,2,45
08/15/2017,13,3,7,14,7,1,45
08/16/2017,9,3,5,12,12,6,47
08/17/2017,9,7,0,14,6,4,40
08/18/2017,16,5,12,10,6,1,50
08/19/2017,9,3,5,14,11,1,43
08/20/2017,13,2,5,14,7,2,43
08/21/2017,11,7,0,11,13,4,46
08/22/2017,12,3,6,16,6,0,43
08/23/2017,5,6,4,10,7,2,34
08/24/2017,12,8,6,16,2,1,45
08/25/2017,14,9,4,13,4,4,48
08/26/2017,13,7,6,13,4,1,44
08/27/2017,13,8,4,12,7,2,46
08/28/2017,22,6,6,17,5,1,57
08/29/2017,10,13,3,11,4,1,42
08/30/2017,14,6,6,15,11,1,53
08/31/2017,9,4,7,6,5,1,32
09/01/2017,23,6,5,13,10,5,62
09/02/2017,12,12,4,12,13,2,55
09/03/2017,20,12,3,13,8,5,61
09/04/2017,24,7,5,14,13,3,66
09/05/2017,13,3,2,19,19,2,58
09/06/2017,15,6,6,12,4,5,48
09/07/2017,18,5,4,11,4,1,43
09/08/2017,11,2,3,12,6,3,37
09/09/2017,13,7,10,14,12,4,60
09/10/2017,22,5,2,20,10,1,60
09/11/2017,6,4,4,11,9,2,36
09/12/2017,16,4,2,7,5,2,36
09/13/2017,14,7,5,18,4,2,50
09/14/2017,11,8,4,15,11,7,56
09/15/2017,13,7,8,20,6,5,59
09/16/2017,12,4,7,17,6,0,46
09/17/2017,25,8,2,11,10,2,58
09/18/2017,8,5,3,12,6,5,39
09/19/2017,9,6,4,14,10,2,45
09/20/2017,10,1,7,14,6,1,39
09/21/2017,19,6,7,13,10,2,57
09/22/2017,11,7,8,16,7,1,50
09/23/2017,20,6,3,14,6,7,56
09/24/2017,14,9,3,22,3,8,59
09/25/2017,16,5,3,8,4,1,37
09/26/2017,10,4,3,10,6,2,35
09/27/2017,10,8,1,9,4,1,33
09/28/2017,8,5,2,11,10,2,38
09/29/2017,13,7,7,15,9,3,54
09/30/2017,19,10,3,13,6,7,58
10/01/2017,20,12,5,23,10,0,70
10/02/2017,18,10,7,20,7,4,66
10/03/2017,16,8,4,13,15,2,58
10/04/2017,11,9,2,22,12,2,58
10/05/2017,13,7,3,20,5,2,50
10/06/2017,6,5,2,19,7,2,41
10/07/2017,13,1,10,17,6,3,50
10/08/2017,11,3,3,15,14,0,46
10/09/2017,18,6,6,13,6,5,54
10/10/2017,22,8,8,7,5,2,52
10/11/2017,9,4,5,14,7,3,42
10/12/2017,14,5,2,17,4,2,44
10/13/2017,21,5,2,12,6,3,49
10/14/2017,13,6,4,17,7,4,51
10/15/2017,19,6,4,17,8,2,56
10/16/2017,14,10,1,11,3,4,43
10/17/2017,15,5,8,12,4,3,47
10/18/2017,14,6,3,16,6,3,48
10/19/2017,21,4,6,17,5,3,56
10/20/2017,14,3,3,15,8,5,48
10/21/2017,12,7,4,23,9,0,55
10/22/2017,17,6,5,11,4,2,45
10/23/2017,14,6,8,14,7,2,51
10/24/2017,20,9,0,8,6,2,45
10/25/2017,14,3,7,8,3,2,37
10/26/2017,11,8,0,14,2,3,38
10/27/2017,11,9,7,20,4,5,56
10/28/2017,17,7,5,22,1,1,53
10/29/2017,7,8,6,8,4,2,35
10/30/2017,10,12,4,9,7,2,44
10/31/2017,8,2,3,20,12,0,45
11/01/2017,15,10,3,18,6,3,55
11/02/2017,17,12,5,18,11,5,68
11/03/2017,18,6,12,16,8,8,68
11/04/2017,19,6,8,17,13,5,68
11/05/2017,11,8,3,21,9,2,54
11/06/2017,16,8,6,14,9,3,56
11/07/2017,12,6,5,22,5,5,55
11/08/2017,10,8,3,22,8,6,57
11/09/2017,13,7,4,24,3,3,54
11/10/2017,16,7,3,10,9,2,47
11/11/2017,12,7,7,16,3,1,46
11/12/2017,10,8,5,21,4,4,52
11/13/2017,15,6,6,13,9,1,50
11/14/2017,10,5,7,22,7,2,53
11/15/2017,9,3,9,23,7,1,52
11/16/2017,16,10,6,19,3,4,58
11/17/2017,20,7,4,23,4,3,61
11/18/2017,19,7,6,14,10,1,57
11/19/2017,13,6,5,16,6,8,54
11/20/2017,14,5,7,20,6,2,54
11/21/2017,7,6,2,15,6,5,41
11/22/2017,10,6,7,17,3,1,44
11/23/2017,22,4,2,20,7,4,59
11/24/2017,9,4,7,10,2,3,35
11/25/2017,15,15,7,12,3,2,54
11/26/2017,11,8,4,18,5,2,48
11/27/2017,14,6,7,24,4,2,57
11/28/2017,20,3,6,14,6,0,49
11/29/2017,10,6,9,21,6,1,53
11/30/2017,14,11,5,14,3,1,48
12/01/2017,26,14,6,23,5,2,76
12/02/2017,25,5,4,23,7,1,65
12/03/2017,27,5,5,18,8,4,67
12/04/2017,13,8,8,13,9,3,54
12/05/2017,25,7,9,14,13,2,70
12/06/2017,13,7,4,20,6,4,54
12/07/2017,19,4,3,27,5,3,61
12/08/2017,10,12,3,17,7,1,50
12/09/2017,17,13,5,16,8,4,63
12/10/2017,20,9,11,19,5,2,66
12/11/2017,17,8,7,16,9,1,58
12/12/2017,9,1,9,17,5,1,42
12/13/2017,16,1,5,17,2,2,43
12/14/2017,9,6,3,18,4,3,43
12/15/2017,16,5,4,16,7,1,49
12/16/2017,18,10,3,26,2,3,62
12/17/2017,19,5,6,15,8,3,56
12/18/2017,27,9,5,15,4,1,61
12/19/2017,19,5,6,17,5,2,54
12/20/2017,10,6,5,8,6,1,36
12/21/2017,12,7,11,15,10,3,58
12/22/2017,19,8,7,24,4,2,64
12/23/2017,24,7,7,18,8,7,71
12/24/2017,22,10,6,18,4,4,64
12/25/2017,23,3,5,21,10,2,64
12/26/2017,13,2,5,20,2,2,44
12/27/2017,11,4,8,19,3,5,50
12/28/2017,20,5,0,13,3,1,42
12/29/2017,8,3,4,7,5,0,27
12/30/2017,13,2,3,11,0,4,33
12/31/2017,6,0,1,6,1,2,16
01/01/2018,27,9,6,28,6,5,81
01/02/2018,16,6,9,20,9,1,61
01/03/2018,13,4,3,22,4,3,49
01/04/2018,11,8,4,12,6,4,45
01/05/2018,17,5,6,13,8,6,55
01/06/2018,14,6,1,16,8,4,49
01/07/2018,8,4,3,13,8,2,38
01/08/2018,11,6,2,10,3,4,36
01/09/2018,20,6,8,16,12,3,65
01/10/2018,14,4,1,10,6,1,36
01/11/2018,11,7,5,17,5,2,47
01/12/2018,14,7,5,8,6,5,45
01/13/2018,13,11,2,21,6,3,56
01/14/2018,19,7,12,14,4,5,61
01/15/2018,10,7,4,20,6,1,48
01/16/2018,12,3,2,17,7,5,46
01/17/2018,10,7,2,13,5,6,43
01/18/2018,13,7,10,10,3,0,43
01/19/2018,12,7,6,26,6,2,59
01/20/2018,20,8,12,6,7,2,55
01/21/2018,16,12,8,30,5,1,72
01/22/2018,24,6,9,8,5,7,59
01/23/2018,12,9,3,17,5,5,51
01/24/2018,10,6,4,10,5,2,37
01/25/2018,18,11,9,23,4,3,68
01/26/2018,16,4,14,21,7,3,65
01/27/2018,22,7,0,13,5,2,49
01/28/2018,24,6,7,17,6,3,63
01/29/2018,14,5,3,16,7,2,47
01/30/2018,18,4,4,8,5,1,40
01/31/2018,18,6,4,11,10,3,52
02/01/2018,17,6,8,13,4,2,50
02/02/2018,17,5,7,21,11,6,67
02/03/2018,12,10,8,11,9,2,52
02/04/2018,23,7,8,10,6,2,56
02/05/2018,21,10,7,15,10,3,66
02/06/2018,15,8,0,14,7,4,48
02/07/2018,5,6,3,17,9,0,40
02/08/2018,16,4,3,16,5,1,45
02/09/2018,17,6,5,12,5,4,49
02/10/2018,20,11,7,20,5,5,68
02/11/2018,21,5,7,12,9,5,59
02/12/2018,17,8,5,22,8,1,61
02/13/2018,20,7,3,10,5,5,50
02/14/2018,9,7,5,8,10,2,41
02/15/2018,21,6,7,10,9,5,58
02/16/2018,13,7,4,18,8,5,55
02/17/2018,22,8,3,21,6,6,66
02/18/2018,23,9,9,18,7,4,70
02/19/2018,9,7,4,15,8,4,47
02/20/2018,17,5,10,18,11,3,64
02/21/2018,16,6,5,14,3,4,48
02/22/2018,9,6,5,15,7,5,47
02/23/2018,17,4,10,14,12,3,60
02/24/2018,16,6,6,11,10,5,54
02/25/2018,23,12,6,18,7,8,74
02/26/2018,8,3,7,20,10,0,48
02/27/2018,8,7,2,17,7,2,43
02/28/2018,22,6,5,12,8,2,55
03/01/2018,12,4,10,20,9,3,58
03/02/2018,20,7,11,21,10,3,72
03/03/2018,21,6,3,12,9,2,53
03/04/2018,15,8,6,17,6,3,55
03/05/2018,24,6,5,21,6,8,70
03/06/2018,10,9,5,26,7,4,61
03/07/2018,11,8,4,13,6,3,45
03/08/2018,13,10,3,16,10,2,54
03/09/2018,20,5,7,11,7,6,56
03/10/2018,22,10,6,13,4,2,57
03/11/2018,6,9,5,27,6,3,56
03/12/2018,19,4,4,11,4,2,44
03/13/2018,8,8,5,13,4,3,41
03/14/2018,9,11,6,9,11,1,47
03/15/2018,15,2,4,16,15,4,56
03/16/2018,12,10,4,21,12,1,60
03/17/2018,21,7,12,17,3,4,64
03/18/2018,19,13,4,15,11,4,66
03/19/2018,12,9,7,18,10,4,60
03/20/2018,18,9,3,10,9,6,55
03/21/2018,11,9,7,33,4,4,68
03/22/2018,11,7,5,14,10,2,49
03/23/2018,9,10,3,14,9,4,49
03/24/2018,15,10,1,19,9,3,57
03/25/2018,17,7,6,9,5,7,51
03/26/2018,11,5,5,14,8,3,46
03/27/2018,16,9,5,11,6,5,52
03/28/2018,10,6,3,12,7,3,41
03/29/2018,22,7,5,7,1,1,43
03/30/2018,10,9,3,7,10,4,43
03/31/2018,21,8,6,19,5,6,65
04/01/2018,15,4,8,11,15,2,55
04/02/2018,13,5,6,12,13,3,52
04/03/2018,14,5,1,19,2,4,45
04/04/2018,15,3,4,15,12,3,52
04/05/2018,20,3,5,14,11,1,54
04/06/2018,14,8,5,17,6,3,53
04/07/2018,18,5,3,15,8,3,52
04/08/2018,11,5,6,14,4,2,42
04/09/2018,17,3,5,16,7,5,53
04/10/2018,19,9,5,24,8,2,67
04/11/2018,12,7,4,22,6,4,55
04/12/2018,19,5,7,30,6,5,72
04/13/2018,26,15,7,33,6,4,91
04/14/2018,24,10,13,23,3,5,78
04/15/2018,25,15,5,29,3,4,81
04/16/2018,24,1,3,19,6,5,58
04/17/2018,13,5,5,9,7,3,42
04/18/2018,15,6,2,7,4,2,36
04/19/2018,12,11,3,13,13,0,52
04/20/2018,11,3,3,18,12,4,51
04/21/2018,17,11,8,15,2,4,57
04/22/2018,11,6,6,8,7,3,41
04/23/2018,8,10,5,8,4,6,41
04/24/2018,15,2,3,10,5,5,40
04/25/2018,13,6,4,13,4,2,42
04/26/2018,10,7,2,10,7,3,39
04/27/2018,16,8,3,10,7,0,44
04/28/2018,10,2,5,8,9,6,40
04/29/2018,10,5,4,13,8,1,41
04/30/2018,9,3,7,8,8,0,35
05/01/2018,12,9,5,9,7,0,42
05/02/2018,5,4,5,13,4,3,34
05/03/2018,12,6,5,11,1,4,39
05/04/2018,9,5,5,10,5,4,38
05/05/2018,16,5,0,19,15,1,56
05/06/2018,8,5,6,21,9,3,52
05/07/2018,10,4,1,15,3,3,36
05/08/2018,9,6,5,15,7,1,43
05/09/2018,7,4,6,13,7,2,39
05/10/2018,14,8,4,12,4,1,43
05/11/2018,16,11,4,16,11,5,63
05/12/2018,12,12,3,19,10,4,60
05/13/2018,21,16,5,18,3,2,65
05/14/2018,15,10,2,20,7,1,55
05/15/2018,22,7,9,20,9,2,69
05/16/2018,16,4,4,15,7,1,47
05/17/2018,8,5,3,8,6,7,37
05/18/2018,15,2,8,14,2,3,44
05/19/2018,9,4,6,16,2,4,41
05/20/2018,14,9,1,11,4,3,42
05/21/2018,6,3,6,18,1,2,36
05/22/2018,7,8,5,14,2,1,37
05/23/2018,10,6,5,8,6,0,35
05/24/2018,8,7,4,12,5,1,37
05/25/2018,17,3,4,16,8,2,50
05/26/2018,23,14,1,16,5,2,61
05/27/2018,17,13,6,7,2,5,50
05/28/2018,14,3,9,14,7,2,49
05/29/2018,7,6,3,11,4,1,32
05/30/2018,7,2,0,12,5,2,28
05/31/2018,18,6,1,13,5,1,44
06/01/2018,12,12,4,16,5,2,51
06/02/2018,20,8,4,17,7,4,60
06/03/2018,13,8,5,11,11,3,51
06/04/2018,9,4,2,10,10,2,37
06/05/2018,12,3,6,20,1,3,45
06/06/2018,16,5,3,22,4,2,52
06/07/2018,9,7,12,13,5,3,49
06/08/2018,7,5,3,7,5,5,32
06/09/2018,19,8,3,9,6,5,50
06/10/2018,10,7,3,13,11,3,47
06/11/2018,15,5,3,9,7,2,41
06/12/2018,11,3,1,11,3,2,31
06/13/2018,14,6,2,8,3,1,34
06/14/2018,13,6,2,12,10,1,44
06/15/2018,8,4,6,9,10,2,39
06/16/2018,10,3,3,9,5,3,33
06/17/2018,14,8,5,19,5,2,53
06/18/2018,18,5,5,11,4,4,47
06/19/2018,8,2,0,10,6,2,28
06/20/2018,11,2,5,8,4,0,30
06/21/2018,16,6,3,16,9,6,56
06/22/2018,14,5,3,13,6,2,43
06/23/2018,16,7,5,15,4,7,54
06/24/2018,16,5,2,7,7,3,40
06/25/2018,10,5,5,16,3,4,43
06/26/2018,13,4,3,7,11,2,40
06/27/2018,10,6,3,11,5,1,36
06/28/2018,7,4,3,11,8,3,36
06/29/2018,10,7,0,5,6,0,28
06/30/2018,11,8,6,8,5,4,42
07/01/2018,19,6,8,13,16,5,67
07/02/2018,10,6,4,9,5,10,44
07/03/2018,10,2,6,14,4,3,39
07/04/2018,15,4,6,15,6,0,46
07/05/2018,9,7,6,15,3,2,42
07/06/2018,9,4,2,17,7,1,40
07/07/2018,7,3,4,11,6,4,35
07/08/2018,15,2,5,11,8,5,46
07/09/2018,17,5,2,14,1,2,41
07/10/2018,13,6,6,10,8,0,43
07/11/2018,10,6,1,10,5,2,34
07/12/2018,16,3,2,15,5,2,43
07/13/2018,5,2,7,12,7,1,34
07/14/2018,14,7,3,11,7,3,45
07/15/2018,10,2,5,15,5,0,37
07/16/2018,13,8,9,16,13,2,61
07/17/2018,19,2,7,12,0,2,42
07/18/2018,11,3,1,7,8,2,32
07/19/2018,5,4,6,10,5,4,34
07/20/2018,11,6,2,11,6,1,37
07/21/2018,9,2,5,13,7,1,37
07/22/2018,12,8,3,15,9,2,49
07/23/2018,17,3,3,10,8,4,45
07/24/2018,10,4,3,13,8,5,43
07/25/2018,15,4,3,14,3,0,39
07/26/2018,15,7,3,15,7,2,49
07/27/2018,16,7,5,12,3,6,49
07/28/2018,9,6,2,8,10,3,38
07/29/2018,13,3,1,8,5,3,33
07/30/2018,10,4,4,12,4,1,35
07/31/2018,10,3,5,14,8,4,44
08/01/2018,14,4,2,12,2,3,37
08/02/2018,10,1,0,14,4,4,33
08/03/2018,10,5,6,12,10,1,44
08/04/2018,17,9,2,12,8,0,48
08/05/2018,20,1,7,12,9,2,51
08/06/2018,9,7,6,21,5,1,49
08/07/2018,9,2,1,10,5,4,31
08/08/2018,5,8,3,17,4,2,39
08/09/2018,10,6,3,11,4,3,37
08/10/2018,8,6,5,12,5,1,37
08/11/2018,16,3,3,13,3,4,42
08/12/2018,14,4,4,16,8,0,46
08/13/2018,21,5,5,11,4,4,50
08/14/2018,14,7,4,10,9,2,46
08/15/2018,19,1,5,11,5,2,43
08/16/2018,14,6,3,6,4,1,34
08/17/2018,20,6,2,7,4,4,43
08/18/2018,12,5,5,12,10,1,45
08/19/2018,13,5,1,8,6,5,38
08/20/2018,9,1,1,17,2,1,31
08/21/2018,5,7,5,13,6,2,38
08/22/2018,14,3,4,7,7,1,36
08/23/2018,14,7,4,6,8,1,40
08/24/2018,19,4,9,9,1,4,46
08/25/2018,15,5,6,14,3,3,46
08/26/2018,11,4,1,7,2,3,28
08/27/2018,19,8,4,10,10,1,52
08/28/2018,13,5,5,11,3,0,37
08/29/2018,17,3,6,11,9,2,48
08/30/2018,11,5,6,5,4,3,34
08/31/2018,8,4,4,14,4,2,36
09/01/2018,13,9,2,17,8,4,53
09/02/2018,10,7,6,21,15,2,61
09/03/2018,10,6,3,13,6,3,41
09/04/2018,12,4,4,7,8,4,39
09/05/2018,7,1,2,15,6,1,32
09/06/2018,14,4,6,16,9,2,51
09/07/2018,14,3,7,14,9,2,49
09/08/2018,16,0,3,16,7,1,43
09/09/2018,10,8,2,15,4,2,41
09/10/2018,16,5,5,14,6,2,48
09/11/2018,7,7,5,9,5,0,33
09/12/2018,15,10,5,15,4,1,50
09/13/2018,13,7,3,13,11,1,48
09/14/2018,10,5,5,9,2,5,36
09/15/2018,8,6,2,8,8,3,35
09/16/2018,13,6,7,6,7,2,41
09/17/2018,11,3,5,13,5,1,38
09/18/2018,10,4,4,8,6,0,32
09/19/2018,15,8,2,6,5,4,40
09/20/2018,7,1,3,9,7,0,27
09/21/2018,14,5,7,13,8,1,48
09/22/2018,14,7,5,10,7,3,46
09/23/2018,13,7,1,22,5,4,52
09/24/2018,9,4,6,9,5,1,34
09/25/2018,13,4,2,9,6,3,37
09/26/2018,10,3,5,11,9,2,40
09/27/2018,15,9,6,8,3,3,44
09/28/2018,8,8,5,10,6,1,38
09/29/2018,13,4,3,19,5,3,47
09/30/2018,20,7,2,15,5,4,53
10/01/2018,10,5,3,7,3,4,32
10/02/2018,13,3,3,17,0,2,38
10/03/2018,7,9,4,11,8,2,41
10/04/2018,9,2,4,10,5,3,33
10/05/2018,15,6,1,12,4,3,41
10/06/2018,20,8,4,5,5,3,45
10/07/2018,17,5,6,14,4,0,46
10/08/2018,12,4,6,10,3,1,36
10/09/2018,18,7,7,19,3,2,56
10/10/2018,12,2,1,22,4,2,43
10/11/2018,15,6,6,14,2,3,46
10/12/2018,18,6,8,10,4,0,46
10/13/2018,14,2,4,14,5,2,41
10/14/2018,10,8,2,14,5,0,39
10/15/2018,16,3,3,18,6,0,46
10/16/2018,9,1,5,9,1,2,27
10/17/2018,12,9,3,12,8,4,48
10/18/2018,14,5,2,10,3,2,36
10/19/2018,13,5,6,19,3,3,49
10/20/2018,23,7,6,12,5,3,56
10/21/2018,19,7,6,10,3,3,48
10/22/2018,6,3,5,12,8,0,34
10/23/2018,18,4,3,9,10,3,47
10/24/2018,13,10,2,12,2,1,40
10/25/2018,16,9,3,13,3,2,46
10/26/2018,8,6,7,12,9,2,44
10/27/2018,11,8,8,9,7,3,46
10/28/2018,29,7,8,21,6,2,73
10/29/2018,15,6,1,13,3,4,42
10/30/2018,10,9,2,13,1,3,38
10/31/2018,19,3,3,13,6,4,48
11/01/2018,18,5,9,17,4,2,55
11/02/2018,16,9,8,20,7,3,63
11/03/2018,17,4,8,19,10,4,62
11/04/2018,24,10,11,19,7,7,78
11/05/2018,23,8,3,14,4,2,54
11/06/2018,13,6,7,11,11,3,51
11/07/2018,8,6,6,12,2,0,34
11/08/2018,18,8,4,17,3,2,52
11/09/2018,15,5,4,14,4,2,44
11/10/2018,15,11,11,19,4,0,60
11/11/2018,22,5,5,17,4,2,55
11/12/2018,14,7,3,20,1,0,45
11/13/2018,18,9,2,15,8,2,54
11/14/2018,14,6,7,14,2,2,45
11/15/2018,7,7,7,17,9,1,48
11/16/2018,8,2,4,13,8,4,39
11/17/2018,15,9,6,25,5,1,61
11/18/2018,13,11,7,16,4,6,57
11/19/2018,14,1,8,14,5,0,42
11/20/2018,18,10,4,16,10,6,64
11/21/2018,19,3,6,16,6,6,56
11/22/2018,16,6,5,15,5,2,49
11/23/2018,17,8,9,23,4,3,64
11/24/2018,16,9,5,17,5,2,54
11/25/2018,16,8,2,17,6,5,54
11/26/2018,12,7,4,13,11,0,47
11/27/2018,21,4,8,15,8,0,56
11/28/2018,12,3,8,14,4,1,42
11/29/2018,7,5,5,12,5,3,37
11/30/2018,19,7,7,13,5,5,56
12/01/2018,24,10,2,13,8,5,62
12/02/2018,18,12,9,21,6,4,70
12/03/2018,15,5,10,14,6,3,53
12/04/2018,14,5,12,6,6,2,45
12/05/2018,16,8,2,23,5,3,57
12/06/2018,18,7,7,23,6,1,62
12/07/2018,14,8,8,17,4,0,51
12/08/2018,23,9,3,21,9,5,70
12/09/2018,12,8,5,17,2,3,47
12/10/2018,13,3,7,10,5,3,41
12/11/2018,5,8,4,18,6,4,45
12/12/2018,12,4,7,9,10,2,44
12/13/2018,15,3,5,17,5,1,46
12/14/2018,13,7,4,15,3,4,46
12/15/2018,17,10,5,15,4,1,52
12/16/2018,23,6,7,6,2,5,49
12/17/2018,19,5,7,15,8,0,54
12/18/2018,13,5,4,15,8,2,47
12/19/2018,11,6,2,15,9,7,50
12/20/2018,11,6,5,19,9,3,53
12/21/2018,11,7,8,14,5,3,48
12/22/2018,25,8,4,14,6,3,60
12/23/2018,19,5,8,11,8,7,58
12/24/2018,17,7,2,16,6,1,49
12/25/2018,18,7,7,13,4,4,53
12/26/2018,11,12,9,17,6,4,59
12/27/2018,11,6,5,8,4,6,40
12/28/2018,18,2,7,14,3,3,47
12/29/2018,20,4,7,17,4,1,53
12/30/2018,8,0,0,8,0,1,17
12/31/2018,7,1,1,6,4,1,20
01/01/2019,30,11,13,37,10,4,105
01/02/2019,13,8,8,18,8,4,59
01/03/2019,20,7,3,19,8,4,61
01/04/2019,23,6,7,12,7,4,59
01/05/2019,23,5,4,9,5,3,49
01/06/2019,20,5,8,13,8,1,55
01/07/2019,18,4,4,22,4,3,55
01/08/2019,16,2,2,10,7,6,43
01/09/2019,11,6,3,17,5,4,46
01/10/2019,14,5,4,14,10,8,55
01/11/2019,11,6,2,24,7,1,51
01/12/2019,18,9,10,31,4,5,77
01/13/2019,31,6,3,21,2,5,68
01/14/2019,22,6,6,17,10,2,63
01/15/2019,19,6,6,10,6,3,50
01/16/2019,12,3,9,13,3,1,41
01/17/2019,22,6,8,16,5,1,58
01/18/2019,14,6,3,12,3,3,41
01/19/2019,18,10,9,22,11,3,73
01/20/2019,16,13,5,23,3,5,65
01/21/2019,17,4,3,20,6,4,54
01/22/2019,12,6,4,19,6,3,50
01/23/2019,16,2,3,8,5,2,36
01/24/2019,17,6,11,15,5,3,57
01/25/2019,20,13,3,16,9,3,64
01/26/2019,20,5,7,26,13,3,74
01/27/2019,36,7,7,24,7,4,85
01/28/2019,12,7,1,16,8,6,50
01/29/2019,19,6,4,13,5,3,50
01/30/2019,14,11,8,23,8,3,67
01/31/2019,20,13,4,23,6,4,70
02/01/2019,17,12,4,15,8,7,63
02/02/2019,18,6,7,29,9,2,71
02/03/2019,21,7,8,23,5,1,65
02/04/2019,12,7,4,34,10,4,71
02/05/2019,16,5,2,30,3,6,62
02/06/2019,10,9,12,21,8,6,66
02/07/2019,9,3,10,29,8,3,62
02/08/2019,21,5,6,23,8,3,66
02/09/2019,13,15,6,13,10,6,63
02/10/2019,26,6,9,20,7,4,72
02/11/2019,16,7,5,25,14,2,69
02/12/2019,19,5,1,13,9,6,53
02/13/2019,14,3,4,12,9,3,45
02/14/2019,6,5,7,12,4,2,36
02/15/2019,18,13,8,18,11,2,70
02/16/2019,14,8,3,20,9,2,56
02/17/2019,18,6,8,23,7,2,64
02/18/2019,17,7,6,17,8,1,56
02/19/2019,9,9,5,20,6,3,52
02/20/2019,22,8,11,25,8,3,77
02/21/2019,10,6,7,14,4,4,45
02/22/2019,25,7,9,19,12,6,78
02/23/2019,14,12,3,11,3,2,45
02/24/2019,11,9,6,23,10,4,63
02/25/2019,9,9,5,15,7,4,49
02/26/2019,15,3,3,25,5,5,56
02/27/2019,19,7,11,15,10,2,64
02/28/2019,13,3,4,16,9,4,49
03/01/2019,14,7,4,19,11,5,60
03/02/2019,25,11,4,18,3,2,63
03/03/2019,21,11,7,20,10,4,73
03/04/2019,9,7,13,9,5,2,45
03/05/2019,16,8,11,13,7,0,55
03/06/2019,19,10,3,13,9,3,57
03/07/2019,23,7,6,21,6,3,66
03/08/2019,13,7,5,20,6,2,53
03/09/2019,14,10,9,26,9,3,71
03/10/2019,13,9,8,18,7,5,60
03/11/2019,22,3,2,19,5,1,52
03/12/2019,15,7,4,20,5,3,54
03/13/2019,15,10,5,16,10,4,60
03/14/2019,18,11,8,11,9,2,59
03/15/2019,13,5,6,18,10,4,56
03/16/2019,18,7,3,19,6,2,55
03/17/2019,10,10,8,18,6,3,55
03/18/2019,15,5,13,16,6,10,65
03/19/2019,23,9,5,31,10,1,79
03/20/2019,13,10,8,15,11,3,60
03/21/2019,13,9,4,13,9,3,51
03/22/2019,10,6,8,13,10,2,49
03/23/2019,12,7,4,13,2,8,46
03/24/2019,21,8,7,11,13,4,64
03/25/2019,15,4,5,13,6,1,44
03/26/2019,21,4,6,21,10,2,64
03/27/2019,15,6,3,12,9,6,51
03/28/2019,10,2,1,14,3,2,32
03/29/2019,11,6,5,19,5,1,47
03/30/2019,15,12,4,18,9,3,61
03/31/2019,12,9,7,15,5,5,53
04/01/2019,16,6,8,13,4,7,54
04/02/2019,13,3,3,18,7,2,46
04/03/2019,13,5,4,20,10,5,57
04/04/2019,10,13,6,14,12,3,58
04/05/2019,16,8,7,17,8,2,58
04/06/2019,20,5,4,11,13,0,53
04/07/2019,19,10,5,16,11,2,63
04/08/2019,11,11,7,10,3,2,44
04/09/2019,10,8,4,24,12,6,64
04/10/2019,20,3,6,31,17,4,81
04/11/2019,18,7,7,19,10,3,64
04/12/2019,31,8,6,24,9,2,80
04/13/2019,17,11,15,39,7,6,95
04/14/2019,24,11,7,21,8,2,73
04/15/2019,18,4,14,36,8,3,83
04/16/2019,27,11,8,16,1,4,67
04/17/2019,17,6,2,8,10,3,46
04/18/2019,17,6,3,15,14,2,57
04/19/2019,9,3,6,10,5,3,36
04/20/2019,11,6,8,11,3,3,42
04/21/2019,8,9,7,12,11,6,53
04/22/2019,15,6,2,20,6,1,50
04/23/2019,7,4,8,13,8,2,42
04/24/2019,17,7,5,16,4,2,51
04/25/2019,14,5,6,24,2,3,54
04/26/2019,13,6,9,15,8,3,54
04/27/2019,18,2,10,19,7,3,59
04/28/2019,20,10,5,10,9,3,57
04/29/2019,11,6,3,6,4,2,32
04/30/2019,7,6,7,16,3,4,43
05/01/2019,17,11,3,17,7,1,56
05/02/2019,20,6,3,20,10,4,63
05/03/2019,20,6,6,15,9,2,58
05/04/2019,18,5,6,27,8,4,68
05/05/2019,19,9,8,16,6,1,59
05/06/2019,15,6,6,10,5,2,44
05/07/2019,18,4,4,9,11,0,46
05/08/2019,16,0,3,21,2,6,48
05/09/2019,15,4,4,22,9,1,55
05/10/2019,13,2,5,8,9,1,38
05/11/2019,13,13,5,18,10,1,60
05/12/2019,14,12,4,13,2,0,45
05/13/2019,8,7,3,11,1,0,30
05/14/2019,22,4,10,15,6,4,61
05/15/2019,10,8,4,21,4,5,52
05/16/2019,17,4,10,17,8,2,58
05/17/2019,10,14,5,17,6,2,54
05/18/2019,15,8,5,15,10,2,55
05/19/2019,11,8,7,17,5,1,49
05/20/2019,9,8,3,12,12,3,47
05/21/2019,15,4,2,12,11,3,47
05/22/2019,6,4,2,11,5,0,28
05/23/2019,14,6,1,14,3,3,41
05/24/2019,11,4,2,18,9,3,47
05/25/2019,13,8,4,16,4,3,48
05/26/2019,10,5,7,13,11,1,47
05/27/2019,18,2,3,15,5,3,46
05/28/2019,15,1,5,12,8,1,42
05/29/2019,12,1,6,11,9,3,42
05/30/2019,6,5,2,15,5,4,37
05/31/2019,17,9,1,9,6,0,42
06/01/2019,17,4,6,17,4,1,49
06/02/2019,19,6,4,18,4,6,57
06/03/2019,12,7,5,16,7,2,49
06/04/2019,9,9,7,10,8,0,43
06/05/2019,14,6,4,18,12,3,57
06/06/2019,16,6,4,6,1,1,34
06/07/2019,11,11,7,15,6,4,54
06/08/2019,15,2,7,26,8,3,61
06/09/2019,18,8,4,21,1,10,62
06/10/2019,14,6,5,14,4,5,48
06/11/2019,12,5,6,16,8,1,48
06/12/2019,24,7,5,15,11,0,62
06/13/2019,15,3,7,16,6,3,50
06/14/2019,15,3,4,18,4,0,44
06/15/2019,20,10,5,13,11,2,61
06/16/2019,23,11,6,17,4,7,68
06/17/2019,23,3,1,13,4,3,47
06/18/2019,10,3,6,16,6,4,45
06/19/2019,9,1,2,12,7,1,32
06/20/2019,15,3,6,23,4,4,55
06/21/2019,10,2,8,16,12,5,53
06/22/2019,18,8,5,13,8,4,56
06/23/2019,19,6,6,9,6,3,49
06/24/2019,17,7,11,9,6,2,52
06/25/2019,13,8,3,6,5,1,36
06/26/2019,17,3,7,13,4,2,46
06/27/2019,18,2,5,7,4,3,39
06/28/2019,16,7,4,18,10,4,59
06/29/2019,17,9,9,14,8,3,60
06/30/2019,14,7,4,15,2,0,42
07/01/2019,15,3,5,8,7,4,42
07/02/2019,17,12,4,26,16,6,81
07/03/2019,20,2,4,13,3,2,44
07/04/2019,11,5,2,20,4,5,47
07/05/2019,13,6,3,8,7,1,38
07/06/2019,18,3,8,20,6,2,57
07/07/2019,12,6,2,15,7,3,45
07/08/2019,18,3,5,13,9,2,50
07/09/2019,15,1,5,16,13,0,50
07/10/2019,13,0,5,14,8,1,41
07/11/2019,13,5,3,14,8,1,44
07/12/2019,18,4,4,18,12,2,58
07/13/2019,15,10,11,18,9,5,68
07/14/2019,15,7,4,14,5,1,46
07/15/2019,9,5,4,26,4,2,50
07/16/2019,13,5,4,12,6,1,41
07/17/2019,16,9,6,17,3,2,53
07/18/2019,13,6,2,13,13,4,51
07/19/2019,14,1,2,14,3,5,39
07/20/2019,13,5,6,12,6,4,46
07/21/2019,16,9,3,13,6,1,48
07/22/2019,12,6,5,10,6,6,45
07/23/2019,15,5,4,12,5,4,45
07/24/2019,8,5,7,9,10,1,40
07/25/2019,15,6,5,8,7,1,42
07/26/2019,13,3,4,15,4,1,40
07/27/2019,20,4,6,16,4,2,52
07/28/2019,18,4,4,12,6,4,48
07/29/2019,20,5,4,5,13,0,47
07/30/2019,17,4,6,12,10,5,54
07/31/2019,10,6,3,14,6,3,42
08/01/2019,12,7,7,11,12,3,52
08/02/2019,14,8,8,9,4,5,48
08/03/2019,18,6,3,19,8,3,57
08/04/2019,9,7,2,21,4,4,47
08/05/2019,13,5,4,3,7,3,35
08/06/2019,12,2,3,10,11,2,40
08/07/2019,7,2,3,8,5,3,28
08/08/2019,8,6,4,7,9,0,34
08/09/2019,10,5,2,13,8,1,39
08/10/2019,19,7,5,26,13,3,73
08/11/2019,16,6,5,13,5,2,47
08/12/2019,14,5,3,10,8,6,46
08/13/2019,14,5,3,13,13,1,49
08/14/2019,13,4,3,11,7,4,42
08/15/2019,7,3,1,11,10,3,35
08/16/2019,17,3,4,17,5,4,50
08/17/2019,15,8,7,14,7,1,52
08/18/2019,17,7,4,12,6,4,50
08/19/2019,14,5,6,10,5,1,41
08/20/2019,19,2,2,13,9,2,47
08/21/2019,11,5,1,13,3,1,34
08/22/2019,6,6,2,11,6,3,34
08/23/2019,18,9,6,9,8,1,51
08/24/2019,21,3,7,9,5,1,46
08/25/2019,18,6,6,12,8,0,50
08/26/2019,13,13,4,21,3,3,57
08/27/2019,3,4,5,9,9,2,32
08/28/2019,13,6,4,10,8,2,43
08/29/2019,16,10,1,8,6,3,44
08/30/2019,15,4,5,10,8,0,42
08/31/2019,17,13,3,14,5,0,52
09/01/2019,12,4,5,13,5,2,41
09/02/2019,13,7,4,10,7,1,42
09/03/2019,15,7,2,8,2,0,34
09/04/2019,14,5,3,6,3,1,32
09/05/2019,15,4,2,15,6,2,44
09/06/2019,13,4,2,16,4,6,45
09/07/2019,13,3,11,18,2,1,48
09/08/2019,21,4,5,19,13,5,67
09/09/2019,15,3,3,6,0,5,32
09/10/2019,10,5,6,17,8,3,49
09/11/2019,14,7,4,13,5,2,45
09/12/2019,14,4,6,9,7,2,42
09/13/2019,11,3,6,13,9,3,45
09/14/2019,11,7,3,11,9,5,46
09/15/2019,10,3,4,11,8,1,37
09/16/2019,15,3,8,21,6,2,55
09/17/2019,18,4,3,12,2,1,40
09/18/2019,13,4,2,20,6,4,49
09/19/2019,11,2,0,17,6,5,41
09/20/2019,9,2,4,11,6,1,33
09/21/2019,18,7,4,12,14,0,55
09/22/2019,12,2,5,14,7,3,43
09/23/2019,9,3,5,21,4,3,45
09/24/2019,10,5,5,12,5,2,39
09/25/2019,13,1,1,12,3,1,31
09/26/2019,17,6,5,14,6,2,50
09/27/2019,12,4,3,14,7,4,44
09/28/2019,13,6,6,18,5,2,50
09/29/2019,14,8,6,17,3,5,53
09/30/2019,16,8,5,19,5,1,54
10/01/2019,17,5,6,17,4,1,50
10/02/2019,11,7,4,16,4,3,45
10/03/2019,12,10,5,13,4,3,47
10/04/2019,16,3,9,19,5,2,54
10/05/2019,6,9,4,12,4,4,39
10/06/2019,15,3,4,19,5,4,50
10/07/2019,13,8,6,8,5,5,45
10/08/2019,11,4,10,13,3,3,44
10/09/2019,8,4,7,13,12,0,44
10/10/2019,11,6,5,13,5,3,43
10/11/2019,6,11,2,13,7,2,41
10/12/2019,10,10,7,24,7,1,59
10/13/2019,14,3,5,16,2,0,40
10/14/2019,9,7,5,16,5,2,44
10/15/2019,13,5,5,21,7,1,52
10/16/2019,8,4,5,21,6,7,51
10/17/2019,13,6,6,17,8,2,52
10/18/2019,14,0,4,15,4,2,39
10/19/2019,12,5,3,16,7,2,45
10/20/2019,15,6,6,22,2,4,55
10/21/2019,12,7,5,15,7,3,49
10/22/2019,11,2,5,10,6,2,36
10/23/2019,22,3,4,14,5,0,48
10/24/2019,14,2,5,11,5,1,38
10/25/2019,12,6,2,18,2,5,45
10/26/2019,13,1,4,15,8,4,45
10/27/2019,14,10,4,16,2,2,48
10/28/2019,12,9,5,17,6,2,51
10/29/2019,13,4,3,20,8,2,50
10/30/2019,9,7,4,14,5,1,40
10/31/2019,12,5,7,16,8,5,53
11/01/2019,17,6,8,12,5,2,50
11/02/2019,19,7,6,19,5,2,58
11/03/2019,12,4,7,17,3,2,45
11/04/2019,15,7,7,19,4,6,58
11/05/2019,8,7,2,7,8,1,33
11/06/2019,18,2,2,17,13,0,52
11/07/2019,13,3,2,20,5,3,46
11/08/2019,22,3,7,21,6,3,62
11/09/2019,17,7,5,14,3,3,49
11/10/2019,24,3,10,19,5,6,67
11/11/2019,14,9,6,13,3,0,45
11/12/2019,11,8,12,17,7,7,62
11/13/2019,16,7,2,11,4,6,46
11/14/2019,16,5,6,13,4,2,46
11/15/2019,15,7,4,11,7,4,48
11/16/2019,10,7,7,14,7,3,48
11/17/2019,5,10,4,18,5,4,46
11/18/2019,24,6,5,17,1,6,59
11/19/2019,15,5,3,22,4,3,52
11/20/2019,10,9,6,17,2,3,47
11/21/2019,19,5,5,11,6,1,47
11/22/2019,17,6,9,23,3,6,64
11/23/2019,13,8,4,17,4,2,48
11/24/2019,11,9,8,18,8,3,57
11/25/2019,10,4,5,20,12,3,54
11/26/2019,9,9,4,18,4,0,44
11/27/2019,11,4,8,18,8,5,54
11/28/2019,13,4,9,18,6,6,56
11/29/2019,7,8,5,16,9,5,50
11/30/2019,22,4,6,22,6,4,64
12/01/2019,16,6,13,20,7,2,64
12/02/2019,18,2,4,12,3,4,43
12/03/2019,10,4,9,13,3,1,40
12/04/2019,14,3,4,10,6,3,40
12/05/2019,19,11,3,17,2,1,53
12/06/2019,13,2,5,24,7,2,53
12/07/2019,20,6,10,21,7,7,71
12/08/2019,17,6,3,20,5,2,53
12/09/2019,10,6,8,10,4,5,43
12/10/2019,17,12,4,8,9,3,53
12/11/2019,12,5,8,14,7,2,48
12/12/2019,14,4,3,15,7,0,43
12/13/2019,15,11,11,17,5,4,63
12/14/2019,16,8,8,20,4,5,61
12/15/2019,12,19,4,17,12,1,65
12/16/2019,17,6,8,11,4,1,47
12/17/2019,12,8,10,16,8,5,59
12/18/2019,15,6,4,14,8,1,48
12/19/2019,21,10,10,17,6,2,66
12/20/2019,16,2,6,10,10,0,44
12/21/2019,15,10,6,16,10,3,60
12/22/2019,13,10,2,18,7,6,56
12/23/2019,9,8,5,22,18,4,66
12/24/2019,19,5,6,16,4,5,55
12/25/2019,11,9,10,10,4,3,47
12/26/2019,14,8,3,13,9,5,52
12/27/2019,13,3,6,14,4,6,46
12/28/2019,15,3,5,18,4,1,46
12/29/2019,15,3,6,9,1,0,34
12/30/2019,2,1,9,14,1,0,27
12/31/2019,3,2,5,17,2,1,30
01/01/2020,15,6,6,34,7,9,77
01/02/2020,22,10,9,15,5,2,63
01/03/2020,14,6,4,23,5,1,53
01/04/2020,7,2,2,17,6,1,35
01/05/2020,13,7,4,17,7,1,49
01/06/2020,22,4,7,14,3,1,51
01/07/2020,8,4,4,11,4,1,32
01/08/2020,17,1,4,14,3,2,41
01/09/2020,11,4,6,17,6,6,50
01/10/2020,23,5,7,9,4,2,50
01/11/2020,10,3,4,19,13,2,51
01/12/2020,14,3,5,21,4,2,49
01/13/2020,15,5,4,12,4,1,41
01/14/2020,12,6,4,23,9,4,58
01/15/2020,14,5,5,11,12,3,50
01/16/2020,17,6,10,14,5,3,55
01/17/2020,17,6,2,11,11,2,49
01/18/2020,13,7,4,20,5,2,51
01/19/2020,16,5,4,17,4,5,51
01/20/2020,15,7,8,19,6,6,61
01/21/2020,8,6,4,24,6,1,49
01/22/2020,13,4,4,22,6,1,50
01/23/2020,12,3,4,20,13,5,57
01/24/2020,19,10,7,20,9,5,70
01/25/2020,20,6,11,28,3,2,70
01/26/2020,13,4,2,14,17,3,53
01/27/2020,16,7,8,15,12,2,60
01/28/2020,14,7,3,8,13,5,50
01/29/2020,17,7,3,20,5,4,56
01/30/2020,11,6,8,16,7,2,50
01/31/2020,16,8,4,6,7,3,44
02/01/2020,20,10,7,14,10,0,61
02/02/2020,23,12,4,16,4,3,62
02/03/2020,16,4,6,15,9,5,55
02/04/2020,13,9,8,13,4,2,49
02/05/2020,16,4,9,24,11,0,64
02/06/2020,17,3,7,7,5,2,41
02/07/2020,16,8,2,22,7,7,62
02/08/2020,9,8,9,17,11,5,59
02/09/2020,13,6,10,6,6,4,45
02/10/2020,9,9,3,20,3,6,50
02/11/2020,11,4,4,20,7,4,50
02/12/2020,18,9,5,16,3,3,54
02/13/2020,15,11,7,18,9,3,63
02/14/2020,12,3,6,12,6,2,41
02/15/2020,17,7,3,26,11,6,70
02/16/2020,15,5,6,12,8,4,50
02/17/2020,21,9,7,10,5,2,54
02/18/2020,14,7,7,13,4,3,48
02/19/2020,22,6,5,14,8,1,56
02/20/2020,13,11,4,17,11,5,61
02/21/2020,24,7,6,9,8,2,56
02/22/2020,19,5,3,16,4,4,51
02/23/2020,16,7,9,16,7,4,59
02/24/2020,19,2,9,15,3,3,51
02/25/2020,14,5,7,16,5,2,49
02/26/2020,23,6,3,6,6,1,45
02/27/2020,11,4,5,8,8,3,39
02/28/2020,13,3,11,18,9,2,56
03/01/2020,41,11,18,36,15,11,132
03/02/2020,17,5,8,14,6,4,54
03/03/2020,23,8,12,14,9,3,69
03/04/2020,20,8,7,16,10,5,66
03/05/2020,12,10,7,15,6,3,53
03/06/2020,17,5,3,23,7,2,57
03/07/2020,21,9,8,15,9,0,62
03/08/2020,24,7,6,20,13,2,72
03/09/2020,19,10,4,18,12,1,64
03/10/2020,23,3,5,14,7,2,54
03/11/2020,14,6,6,11,10,6,53
03/12/2020,11,8,5,16,7,3,50
03/13/2020,10,3,9,14,13,2,51
03/14/2020,13,11,11,15,13,2,65
03/15/2020,13,3,9,18,6,4,53
03/16/2020,11,5,8,22,3,4,53
03/17/2020,12,1,4,13,5,2,37
03/18/2020,11,1,8,13,8,2,43
03/19/2020,14,10,7,21,10,0,62
03/20/2020,9,3,5,16,9,1,43
03/21/2020,17,7,7,8,9,2,50
03/22/2020,15,6,6,12,7,5,51
03/23/2020,11,3,3,13,9,6,45
03/24/2020,10,8,0,13,4,4,39
03/25/2020,13,4,6,9,6,2,40
03/26/2020,11,3,1,12,5,4,36
03/27/2020,6,3,0,9,8,3,29
03/28/2020,16,4,3,13,2,4,42
03/29/2020,7,7,3,16,6,0,39
03/30/2020,9,5,3,12,4,2,35
03/31/2020,16,3,4,7,5,3,38
04/01/2020,20,4,1,15,2,3,45
04/02/2020,15,6,1,11,2,5,40
04/03/2020,10,3,4,12,5,2,36
04/04/2020,10,6,3,8,3,1,31
04/05/2020,12,6,5,8,6,2,39
04/06/2020,6,5,3,7,1,1,23
04/07/2020,17,7,2,9,3,2,40
04/08/2020,8,3,3,3,4,1,22
04/09/2020,12,1,1,9,5,1,29
04/10/2020,7,4,2,5,0,1,19
04/11/2020,7,4,1,9,3,0,24
04/12/2020,9,4,3,9,5,0,30
04/13/2020,12,2,2,10,4,0,30
04/14/2020,3,6,3,5,4,2,23
04/15/2020,10,2,7,7,3,0,29
04/16/2020,12,6,2,5,5,3,33
04/17/2020,6,2,4,6,4,2,24
04/18/2020,10,1,1,5,1,1,19
04/19/2020,5,3,4,8,5,1,26
04/20/2020,7,4,7,6,7,2,33
04/21/2020,10,1,4,8,2,1,26
04/22/2020,10,2,3,8,2,1,26
04/23/2020,9,4,3,6,9,2,33
04/24/2020,9,1,4,11,4,1,30
04/25/2020,6,2,3,5,4,1,21
04/26/2020,5,1,3,11,3,4,27
04/27/2020,10,5,2,12,6,1,36
04/28/2020,11,4,5,11,4,4,39
04/29/2020,7,2,3,11,4,2,29
04/30/2020,5,8,7,9,0,2,31
05/01/2020,11,6,1,9,2,4,33
05/02/2020,14,2,5,10,3,0,34
05/03/2020,7,6,4,18,5,3,43
05/04/2020,11,6,3,17,9,3,49
05/05/2020,13,6,6,10,5,4,44
05/06/2020,8,7,2,10,8,1,36
05/07/2020,7,2,3,12,8,5,37
05/08/2020,13,7,2,12,2,3,39
05/09/2020,15,8,3,18,8,2,54
05/10/2020,12,5,2,13,5,2,39
05/11/2020,14,3,1,19,6,2,45
05/12/2020,15,6,3,10,2,3,39
05/13/2020,10,0,4,14,4,0,32
05/14/2020,15,5,7,14,3,2,46
05/15/2020,11,3,3,8,4,5,34
05/16/2020,13,2,1,14,5,2,37
05/17/2020,15,4,4,14,2,2,41
05/18/2020,10,4,3,17,3,3,40
05/19/2020,12,7,3,16,5,0,43
05/20/2020,11,2,1,7,5,2,28
05/21/2020,5,7,5,10,9,0,36
05/22/2020,12,4,5,16,5,2,44
05/23/2020,11,4,4,10,6,3,38
05/24/2020,9,6,2,18,9,1,45
05/25/2020,4,0,6,9,4,1,24
05/26/2020,10,7,5,11,5,1,39
05/27/2020,11,5,1,13,9,2,41
05/28/2020,16,0,3,11,12,1,43
05/29/2020,16,6,6,12,10,1,51
05/30/2020,21,4,1,11,6,3,46
05/31/2020,12,7,3,19,6,5,52
06/01/2020,14,8,2,13,4,4,45
06/02/2020,11,6,0,11,8,5,41
06/03/2020,11,5,4,7,4,1,32
06/04/2020,10,4,6,15,6,2,43
06/05/2020,7,4,9,20,5,3,48
06/06/2020,14,2,4,11,7,3,41
06/07/2020,17,4,3,8,2,0,34
06/08/2020,8,3,5,17,4,1,38
06/09/2020,9,3,6,11,8,3,40
06/10/2020,12,3,3,12,0,1,31
06/11/2020,21,4,3,14,7,0,49
06/12/2020,10,8,4,9,5,3,39
06/13/2020,12,3,2,17,4,2,40
06/14/2020,11,6,5,7,3,5,37
06/15/2020,12,3,3,12,5,1,36
06/16/2020,4,5,7,10,8,4,38
06/17/2020,9,11,3,11,8,2,44
06/18/2020,8,5,3,16,5,2,39
06/19/2020,11,7,1,7,7,2,35
06/20/2020,8,4,7,11,7,2,39
06/21/2020,20,6,0,11,3,2,42
06/22/2020,12,3,5,11,11,3,45
06/23/2020,12,7,1,9,3,4,36
06/24/2020,13,6,7,24,7,6,63
06/25/2020,7,9,3,17,5,0,41
06/26/2020,10,3,3,10,4,2,32
06/27/2020,11,2,3,19,3,5,43
06/28/2020,15,3,5,8,10,3,44
06/29/2020,13,6,8,21,1,0,49
06/30/2020,13,4,7,15,4,1,44
07/01/2020,12,4,2,12,2,5,37
07/02/2020,10,6,4,13,7,6,46
07/03/2020,6,6,4,14,6,2,38
07/04/2020,16,11,1,13,6,2,49
07/05/2020,8,6,9,9,7,1,40
07/06/2020,20,6,7,21,4,0,58
07/07/2020,8,2,2,7,3,3,25
07/08/2020,7,5,4,9,5,1,31
07/09/2020,18,1,4,12,3,1,39
07/10/2020,14,3,3,17,8,1,46
07/11/2020,15,9,5,10,4,3,46
07/12/2020,11,1,4,8,1,2,27
07/13/2020,16,3,2,10,6,2,39
07/14/2020,15,3,4,19,2,1,44
07/15/2020,6,4,3,17,2,4,36
07/16/2020,6,2,9,12,7,2,38
07/17/2020,16,4,6,15,16,3,60
07/18/2020,14,4,5,14,2,3,42
07/19/2020,7,9,7,10,8,1,42
07/20/2020,7,7,1,19,12,6,52
07/21/2020,12,4,5,18,6,4,49
07/22/2020,17,6,6,19,5,1,54
07/23/2020,7,1,5,11,5,3,32
07/24/2020,12,5,8,18,6,4,53
07/25/2020,20,9,7,18,3,3,60
07/26/2020,12,4,9,27,7,3,62
07/27/2020,17,7,5,13,7,4,53
07/28/2020,14,8,6,16,2,2,48
07/29/2020,12,4,5,17,7,1,46
07/30/2020,15,3,4,17,4,0,43
07/31/2020,9,4,1,17,7,3,41
08/01/2020,11,3,6,23,9,1,53
08/02/2020,15,4,4,14,4,2,43
08/03/2020,12,8,5,10,5,1,41
08/04/2020,11,5,5,10,4,1,36
08/05/2020,15,2,5,17,1,1,41
08/06/2020,9,6,3,12,7,5,42
08/07/2020,20,7,3,15,5,2,52
08/08/2020,21,5,6,14,11,4,61
08/09/2020,15,5,11,23,5,2,61
08/10/2020,15,6,5,17,8,1,52
08/11/2020,14,8,2,15,6,4,49
08/12/2020,12,5,5,12,8,1,43
08/13/2020,10,3,2,11,3,1,30
08/14/2020,6,6,7,19,3,3,44
08/15/2020,15,2,15,11,10,2,55
08/16/2020,19,11,2,10,4,0,46
08/17/2020,9,3,5,13,15,0,45
08/18/2020,8,5,3,12,9,1,38
08/19/2020,14,4,3,16,2,0,39
08/20/2020,10,5,3,14,5,0,37
08/21/2020,11,7,0,12,5,7,42
08/22/2020,19,5,4,16,4,4,52
08/23/2020,12,11,4,12,10,0,49
08/24/2020,11,4,5,6,4,1,31
08/25/2020,14,8,1,9,10,4,46
08/26/2020,15,4,4,13,9,3,48
08/27/2020,14,0,3,14,10,4,45
08/28/2020,12,4,5,15,5,1,42
08/29/2020,19,7,6,18,7,2,59
08/30/2020,24,6,4,12,4,4,54
08/31/2020,14,2,0,15,7,5,43
09/01/2020,7,5,6,13,4,5,40
09/02/2020,17,8,9,23,5,2,64
09/03/2020,6,4,8,13,7,1,39
09/04/2020,16,4,5,7,7,4,43
09/05/2020,17,8,3,17,6,4,55
09/06/2020,14,5,9,18,2,1,49
09/07/2020,13,3,3,10,2,3,34
09/08/2020,10,2,1,11,10,2,36
09/09/2020,8,4,3,10,2,6,33
09/10/2020,17,5,2,11,5,4,44
09/11/2020,12,11,4,15,5,0,47
09/12/2020,9,4,8,13,4,2,40
09/13/2020,11,5,4,17,7,5,49
09/14/2020,16,2,8,12,5,3,46
09/15/2020,17,4,2,14,6,3,46
09/16/2020,19,3,7,7,2,6,44
09/17/2020,7,4,2,21,3,3,40
09/18/2020,12,3,5,14,10,1,45
09/19/2020,10,7,8,11,7,4,47
09/20/2020,21,4,6,12,1,1,45
09/21/2020,17,9,6,8,3,3,46
09/22/2020,17,4,4,12,3,4,44
09/23/2020,15,5,5,15,5,4,49
09/24/2020,8,4,5,15,3,6,41
09/25/2020,13,5,5,19,5,6,53
09/26/2020,12,7,4,20,7,1,51
09/27/2020,11,5,5,17,6,1,45
09/28/2020,11,4,5,12,6,2,40
09/29/2020,12,3,4,17,8,3,47
09/30/2020,15,4,3,26,4,1,53
10/01/2020,11,11,10,21,9,0,62
10/02/2020,15,5,5,12,2,7,46
10/03/2020,17,6,5,17,3,2,50
10/04/2020,21,6,6,15,5,4,57
10/05/2020,14,9,6,13,9,2,53
10/06/2020,16,3,5,13,5,1,43
10/07/2020,20,3,5,18,6,4,56
10/08/2020,16,7,5,12,6,2,48
10/09/2020,13,2,8,17,2,2,44
10/10/2020,21,4,6,13,6,4,54
10/11/2020,13,15,5,25,2,3,63
10/12/2020,14,9,5,13,5,4,50
10/13/2020,15,3,5,12,3,1,39
10/14/2020,13,4,9,11,6,3,46
10/15/2020,19,4,6,9,3,5,46
10/16/2020,17,2,6,13,4,4,46
10/17/2020,13,3,9,10,4,3,42
10/18/2020,22,6,5,12,7,3,55
10/19/2020,12,3,7,8,1,4,35
10/20/2020,14,3,3,12,4,3,39
10/21/2020,21,9,5,11,8,1,55
10/22/2020,17,7,5,13,3,4,49
10/23/2020,11,8,8,22,3,2,54
10/24/2020,10,11,9,20,5,3,58
10/25/2020,24,12,7,13,5,2,63
10/26/2020,24,5,2,18,8,3,60
10/27/2020,11,7,9,12,6,1,46
10/28/2020,12,7,6,8,6,2,41
10/29/2020,14,6,8,11,5,1,45
10/30/2020,12,4,10,21,6,8,61
10/31/2020,18,10,3,13,4,4,52
11/01/2020,20,5,6,20,10,7,68
11/02/2020,17,2,7,17,8,4,55
11/03/2020,13,4,8,19,3,2,49
11/04/2020,11,5,2,13,3,2,36
11/05/2020,15,7,5,11,2,1,41
11/06/2020,22,4,3,16,6,4,55
11/07/2020,8,5,5,24,6,2,50
11/08/2020,17,5,15,10,8,3,58
11/09/2020,8,5,10,13,7,1,44
11/10/2020,21,7,7,18,6,3,62
11/11/2020,12,2,7,14,1,4,40
11/12/2020,14,5,1,16,5,2,43
11/13/2020,13,5,5,23,2,1,49
11/14/2020,22,6,6,19,7,3,63
11/15/2020,19,9,9,25,1,1,64
11/16/2020,23,6,9,21,2,6,67
11/17/2020,10,8,3,17,5,1,44
11/18/2020,21,3,12,17,6,4,63
11/19/2020,13,8,6,21,1,3,52
11/20/2020,18,5,8,17,8,2,58
11/21/2020,22,6,11,22,3,6,70
11/22/2020,23,2,5,15,2,6,53
11/23/2020,21,4,5,27,8,7,72
11/24/2020,14,5,2,19,4,4,48
11/25/2020,18,5,5,19,3,2,52
11/26/2020,18,9,6,12,4,4,53
11/27/2020,16,6,2,22,4,0,50
11/28/2020,21,8,3,25,3,2,62
11/29/2020,23,7,5,28,3,2,68
11/30/2020,22,7,8,16,5,4,62
12/01/2020,20,4,3,16,9,5,57
12/02/2020,13,5,5,22,3,0,48
12/03/2020,14,7,9,25,4,2,61
12/04/2020,15,9,4,19,4,3,54
12/05/2020,18,14,9,17,5,2,65
12/06/2020,26,6,8,13,6,1,60
12/07/2020,19,5,4,9,4,2,43
12/08/2020,13,7,2,14,5,5,46
12/09/2020,15,4,4,17,7,2,49
12/10/2020,21,4,7,12,6,4,54
12/11/2020,12,5,8,13,6,7,51
12/12/2020,22,6,7,20,8,4,67
12/13/2020,15,5,9,16,4,5,54
12/14/2020,21,4,3,16,4,1,49
12/15/2020,15,4,4,15,10,5,53
12/16/2020,18,8,4,23,4,3,60
12/17/2020,17,5,6,15,4,6,53
12/18/2020,21,5,6,22,4,3,61
12/19/2020,24,8,5,14,7,5,63
12/20/2020,16,6,7,13,5,8,55
12/21/2020,18,8,5,19,9,4,63
12/22/2020,19,4,4,12,1,4,44
12/23/2020,12,5,4,22,9,7,59
12/24/2020,15,6,4,20,7,2,54
12/25/2020,23,6,6,20,6,3,64
12/26/2020,16,7,5,21,5,2,56
12/27/2020,23,7,7,29,4,5,75
12/28/2020,16,6,4,24,3,1,54
12/29/2020,12,7,9,20,4,5,57
12/30/2020,22,5,8,27,6,5,73
12/31/2020,20,7,4,21,5,3,60
01/01/2021,21,9,12,29,9,2,82
01/02/2021,14,3,11,19,11,2,60
01/03/2021,14,6,9,15,6,4,54
01/04/2021,6,3,3,15,6,2,35
01/05/2021,11,5,5,20,5,3,49
01/06/2021,14,5,5,14,5,3,46
01/07/2021,15,2,2,14,4,2,39
01/08/2021,4,2,4,16,2,2,30
01/09/2021,13,7,7,16,4,0,47
01/10/2021,14,7,5,12,6,2,46
01/11/2021,9,3,5,12,2,3,34
01/12/2021,19,8,5,10,5,0,47
01/13/2021,12,2,1,9,8,2,34
01/14/2021,10,5,2,10,6,2,35
01/15/2021,6,9,5,13,2,1,36
01/16/2021,15,7,5,16,2,2,47
01/17/2021,18,3,5,17,9,2,54
01/18/2021,15,2,2,8,7,4,38
01/19/2021,14,3,3,13,6,0,39
01/20/2021,12,1,7,14,5,0,39
01/21/2021,14,1,4,23,3,2,47
01/22/2021,19,5,3,13,7,3,50
01/23/2021,12,5,3,15,7,3,45
01/24/2021,15,5,1,16,4,1,42
01/25/2021,12,5,9,16,6,4,52
01/26/2021,11,8,4,18,2,2,45
01/27/2021,6,0,3,25,0,4,38
01/28/2021,7,7,3,11,5,5,38
01/29/2021,10,1,4,9,4,2,30
01/30/2021,3,0,0,5,3,0,11
01/31/2021,6,0,0,5,1,0,12
02/01/2021,7,4,6,12,8,1,38
02/02/2021,17,8,5,17,7,3,57
02/03/2021,16,5,3,11,7,1,43
02/04/2021,11,5,5,14,5,1,41
02/05/2021,17,10,8,20,2,3,60
02/06/2021,13,10,5,19,3,3,53
02/07/2021,18,10,6,16,2,1,53
02/08/2021,10,6,9,20,9,2,56
02/09/2021,15,10,1,9,7,0,42
02/10/2021,10,4,2,10,5,2,33
02/11/2021,14,4,3,9,6,5,41
02/12/2021,13,4,6,16,5,0,44
02/13/2021,17,14,3,24,7,4,69
02/14/2021,8,6,7,24,9,2,56
02/15/2021,16,4,4,13,6,4,47
02/16/2021,17,10,2,11,4,2,46
02/17/2021,18,3,3,19,9,3,55
02/18/2021,18,5,3,18,4,5,53
02/19/2021,14,6,3,26,5,3,57
02/20/2021,21,11,6,22,13,2,75
02/21/2021,16,8,5,21,9,7,66
02/22/2021,16,4,4,18,7,2,51
02/23/2021,10,7,7,20,3,3,50
02/24/2021,16,1,4,19,9,3,52
02/25/2021,14,5,7,21,2,2,51
02/26/2021,22,4,11,28,5,2,72
02/27/2021,11,3,4,13,10,1,42
02/28/2021,15,5,3,24,6,6,59
03/01/2021,12,5,9,20,12,1,59
03/02/2021,20,10,9,15,5,5,64
03/03/2021,24,2,6,23,8,1,64
03/04/2021,12,4,9,13,7,1,46
03/05/2021,14,7,11,12,4,1,49
03/06/2021,15,7,8,26,11,5,72
03/07/2021,24,8,3,18,4,5,62
03/08/2021,11,7,7,21,5,7,58
03/09/2021,13,6,6,18,8,4,55
03/10/2021,24,8,4,19,8,3,66
03/11/2021,8,4,5,15,4,4,40
03/12/2021,21,4,6,28,9,2,70
03/13/2021,15,7,4,19,12,5,62
03/14/2021,19,8,8,20,10,2,67
03/15/2021,15,6,5,15,3,2,46
03/16/2021,17,4,3,14,4,1,43
03/17/2021,10,4,6,17,11,2,50
03/18/2021,8,1,5,13,7,3,37
03/19/2021,13,2,6,18,8,4,51
03/20/2021,14,4,7,19,5,2,51
03/21/2021,13,3,4,15,4,4,43
03/22/2021,13,2,5,20,4,2,46
03/23/2021,9,2,5,13,13,3,45
03/24/2021,14,8,5,18,8,5,58
03/25/2021,17,7,11,11,5,1,52
03/26/2021,10,1,6,13,6,2,38
03/27/2021,15,7,5,13,5,3,48
03/28/2021,19,9,5,20,9,1,63
03/29/2021,17,4,10,11,3,4,49
03/30/2021,10,7,1,16,11,3,48
03/31/2021,6,4,6,17,7,3,43
04/01/2021,19,6,7,21,7,5,65
04/02/2021,14,10,6,21,6,1,58
04/03/2021,11,4,10,19,7,2,53
04/04/2021,14,5,6,9,9,4,47
04/05/2021,11,6,3,8,5,4,37
04/06/2021,10,4,3,13,3,3,36
04/07/2021,8,3,1,13,9,0,34
04/08/2021,19,8,6,18,4,2,57
04/09/2021,8,7,2,19,6,1,43
04/10/2021,12,4,5,19,7,2,49
04/11/2021,15,3,3,21,10,1,53
04/12/2021,16,9,4,25,3,3,60
04/13/2021,11,6,4,19,4,3,47
04/14/2021,17,4,3,15,3,7,49
04/15/2021,8,4,5,14,6,1,38
04/16/2021,8,5,2,8,6,3,32
04/17/2021,9,4,3,14,4,0,34
04/18/2021,11,2,3,12,1,3,32
04/19/2021,7,5,4,14,3,4,37
04/20/2021,10,2,1,10,5,1,29
04/21/2021,8,6,5,13,7,1,40
04/22/2021,11,4,2,11,9,4,41
04/23/2021,14,6,6,15,4,3,48
04/24/2021,8,7,3,8,4,2,32
04/25/2021,10,3,2,11,5,2,33
04/26/2021,15,3,2,12,7,4,43
04/27/2021,9,5,2,11,5,3,35
04/28/2021,6,5,9,11,3,6,40
04/29/2021,9,5,1,12,1,3,31
04/30/2021,12,5,8,7,7,1,40
05/01/2021,6,2,10,12,4,2,36
05/02/2021,12,5,5,7,6,2,37
05/03/2021,5,5,2,15,1,1,29
05/04/2021,6,2,3,16,4,3,34
05/05/2021,7,7,1,8,8,3,34
05/06/2021,8,2,5,11,3,3,32
05/07/2021,14,4,3,12,5,3,41
05/08/2021,14,5,4,9,6,2,40
05/09/2021,11,3,2,10,6,1,33
05/10/2021,10,6,4,9,5,2,36
05/11/2021,9,7,4,9,6,1,36
05/12/2021,11,3,6,13,4,2,39
05/13/2021,12,3,5,10,4,1,35
05/14/2021,12,3,5,12,4,2,38
05/15/2021,9,5,3,4,5,3,29
05/16/2021,14,6,5,7,5,4,41
05/17/2021,16,8,3,14,9,7,57
05/18/2021,11,4,2,12,6,1,36
05/19/2021,12,5,1,12,7,6,43
05/20/2021,20,10,4,11,3,2,50
05/21/2021,15,10,4,11,6,4,50
05/22/2021,13,3,2,19,4,2,43
05/23/2021,7,4,3,17,0,7,38
05/24/2021,14,1,2,12,3,3,35
05/25/2021,11,5,1,14,6,4,41
05/26/2021,9,3,6,12,5,0,35
05/27/2021,8,2,1,9,5,3,28
05/28/2021,19,8,6,8,4,1,46
05/29/2021,9,9,3,9,5,4,39
05/30/2021,13,6,5,10,4,1,39
05/31/2021,6,5,1,8,3,2,25
06/01/2021,11,5,3,14,3,2,38
06/02/2021,13,3,7,13,2,1,39
06/03/2021,11,3,4,16,6,0,40
06/04/2021,10,5,6,10,4,3,38
06/05/2021,12,3,5,12,6,3,41
06/06/2021,8,6,3,7,6,0,30
06/07/2021,9,5,2,6,13,1,36
06/08/2021,13,5,6,6,10,2,42
06/09/2021,8,6,1,8,8,4,35
06/10/2021,9,0,4,10,1,5,29
06/11/2021,13,7,2,7,4,1,34
06/12/2021,16,5,1,11,2,2,37
06/13/2021,10,6,3,8,3,4,34
06/14/2021,7,7,3,15,3,2,37
06/15/2021,14,1,4,13,7,0,39
06/16/2021,14,5,2,7,2,1,31
06/17/2021,14,8,4,9,1,1,37
06/18/2021,10,2,1,7,3,2,25
06/19/2021,9,3,3,16,1,3,35
06/20/2021,15,9,3,8,5,1,41
06/21/2021,12,4,1,12,1,2,32
06/22/2021,10,5,8,14,4,1,42
06/23/2021,6,4,2,17,4,2,35
06/24/2021,11,5,2,12,6,3,39
06/25/2021,18,8,4,10,7,0,47
06/26/2021,19,3,4,16,5,1,48
06/27/2021,10,5,4,4,11,3,37
06/28/2021,10,3,2,6,5,1,27
06/29/2021,12,8,1,15,8,3,47
06/30/2021,9,4,2,9,6,5,35
07/01/2021,14,6,8,8,12,4,52
07/02/2021,7,4,4,8,3,4,30
07/03/2021,10,5,4,12,8,4,43
07/04/2021,12,3,8,9,7,2,41
07/05/2021,15,2,2,16,6,0,41
07/06/2021,12,3,6,12,5,1,39
07/07/2021,9,6,3,9,3,1,31
07/08/2021,13,4,3,11,6,1,38
07/09/2021,15,6,4,8,1,0,34
07/10/2021,7,7,3,12,7,2,38
07/11/2021,3,5,6,7,4,0,25
07/12/2021,12,8,5,12,6,1,44
07/13/2021,12,2,4,13,4,1,36
07/14/2021,12,2,3,7,3,0,27
07/15/2021,10,6,3,11,6,3,39
07/16/2021,3,4,5,11,4,1,28
07/17/2021,8,1,9,10,2,3,33
07/18/2021,11,2,5,10,9,0,37
07/19/2021,9,6,3,12,3,2,35
07/20/2021,5,3,8,13,5,0,34
07/21/2021,9,3,2,8,4,1,27
07/22/2021,9,2,1,8,4,2,26
07/23/2021,5,1,3,8,4,1,22
07/24/2021,5,2,3,11,9,4,34
07/25/2021,4,3,1,8,4,1,21
07/26/2021,15,2,3,10,5,1,36
07/27/2021,9,3,3,7,4,0,26
07/28/2021,10,6,2,8,2,5,33
07/29/2021,4,3,4,8,4,0,23
07/30/2021,13,2,5,7,5,4,36
07/31/2021,2,4,4,11,8,3,32
08/01/2021,9,9,3,10,3,0,34
08/02/2021,6,6,1,12,4,2,31
08/03/2021,16,4,2,12,7,0,41
08/04/2021,12,4,3,10,0,1,30
08/05/2021,8,6,5,13,4,1,37
08/06/2021,7,5,2,7,5,3,29
08/07/2021,10,4,3,12,8,1,38
08/08/2021,12,1,2,8,7,0,30
08/09/2021,6,5,1,17,5,0,34
08/10/2021,7,5,2,13,8,2,37
08/11/2021,15,7,4,16,5,1,48
08/12/2021,4,0,5,9,9,3,30
08/13/2021,11,3,3,9,3,1,30
08/14/2021,3,5,0,11,6,1,26
08/15/2021,8,5,3,4,3,1,24
08/16/2021,13,5,4,13,5,3,43
08/17/2021,12,2,3,13,4,0,34
08/18/2021,9,6,3,8,3,0,29
08/19/2021,13,5,2,11,7,0,38
08/20/2021,11,5,5,8,3,0,32
08/21/2021,10,3,7,6,5,0,31
08/22/2021,15,5,3,13,6,6,48
08/23/2021,11,1,6,11,2,4,35
08/24/2021,11,4,4,5,2,3,29
08/25/2021,12,3,5,9,2,0,31
08/26/2021,7,3,7,10,5,2,34
08/27/2021,7,3,4,5,8,3,30
08/28/2021,9,7,4,7,6,5,38
08/29/2021,8,7,5,16,4,1,41
08/30/2021,14,3,1,9,4,2,33
08/31/2021,10,5,6,5,5,0,31
09/01/2021,8,3,3,9,4,1,28
09/02/2021,9,3,3,7,4,1,27
09/03/2021,7,5,3,15,4,2,36
09/04/2021,10,6,8,13,3,4,44
09/05/2021,9,1,3,12,4,0,29
09/06/2021,15,4,5,8,3,1,36
09/07/2021,11,4,1,7,3,1,27
09/08/2021,11,3,1,4,1,1,21
09/09/2021,6,4,3,9,3,1,26
09/10/2021,7,5,2,14,8,1,37
09/11/2021,10,5,5,16,6,1,43
09/12/2021,16,7,1,7,4,4,39
09/13/2021,7,5,2,14,2,1,31
09/14/2021,8,3,4,8,3,1,27
09/15/2021,8,5,5,10,7,1,36
09/16/2021,8,4,4,8,7,0,31
09/17/2021,5,6,5,7,2,4,29
09/18/2021,11,3,2,15,3,2,36
09/19/2021,13,7,4,10,7,1,42
09/20/2021,7,4,2,10,5,2,30
09/21/2021,5,5,5,7,3,4,29
09/22/2021,4,5,3,4,7,2,25
09/23/2021,12,4,6,15,5,3,45
09/24/2021,11,11,3,5,1,2,33
09/25/2021,6,3,2,11,11,4,37
09/26/2021,14,3,4,14,2,0,37
09/27/2021,10,4,6,7,1,1,29
09/28/2021,14,6,4,4,8,1,37
09/29/2021,11,8,2,5,4,1,31
09/30/2021,9,4,9,9,3,2,36
10/01/2021,13,3,5,9,7,7,44
10/02/2021,9,5,4,11,8,0,37
10/03/2021,16,11,8,8,8,0,51
10/04/2021,10,5,5,25,3,2,50
10/05/2021,8,9,2,10,8,2,39
10/06/2021,13,5,4,12,8,2,44
10/07/2021,16,2,4,14,5,1,42
10/08/2021,14,1,6,14,4,3,42
10/09/2021,10,6,8,9,4,0,37
10/10/2021,12,3,3,4,5,1,28
10/11/2021,16,5,8,10,5,1,45
10/12/2021,13,1,4,11,6,2,37
10/13/2021,8,1,2,14,5,1,31
10/14/2021,4,2,2,5,2,3,18
10/15/2021,6,1,3,12,2,2,26
10/16/2021,8,5,3,14,3,3,36
10/17/2021,5,6,7,9,4,4,35
10/18/2021,13,1,5,12,4,1,36
10/19/2021,12,3,4,4,2,1,26
10/20/2021,8,1,4,2,8,4,27
10/21/2021,8,3,3,15,2,1,32
10/22/2021,12,2,3,6,1,1,25
10/23/2021,12,2,3,13,4,1,35
10/24/2021,10,2,4,10,1,0,27
10/25/2021,12,5,3,18,2,4,44
10/26/2021,10,2,2,14,4,0,32
10/27/2021,12,3,8,11,4,4,42
10/28/2021,13,5,2,14,4,2,40
10/29/2021,8,9,5,19,1,1,43
10/30/2021,8,7,0,16,5,1,37
10/31/2021,9,3,5,17,4,4,42
11/01/2021,11,4,3,18,5,1,42
11/02/2021,10,5,4,10,2,2,33
11/03/2021,8,3,0,15,6,2,34
11/04/2021,5,1,3,24,4,3,40
11/05/2021,14,4,4,27,8,0,57
11/06/2021,17,3,5,22,5,0,52
11/07/2021,10,2,3,19,4,2,40
11/08/2021,15,4,3,7,3,4,36
11/09/2021,15,4,2,15,5,0,41
11/10/2021,12,4,4,13,5,3,41
11/11/2021,18,6,7,16,5,1,53
11/12/2021,12,7,3,18,8,0,48
11/13/2021,9,6,4,16,3,1,39
11/14/2021,11,9,4,12,6,3,45
11/15/2021,13,7,3,17,3,0,43
11/16/2021,12,4,6,13,2,2,39
11/17/2021,11,6,2,16,4,1,40
11/18/2021,18,6,6,10,5,0,45
11/19/2021,12,3,11,21,1,1,49
11/20/2021,11,5,4,27,6,4,57
11/21/2021,11,4,7,17,5,2,46
11/22/2021,9,5,6,13,7,0,40
11/23/2021,15,2,6,14,2,5,44
11/24/2021,6,6,3,32,2,1,50
11/25/2021,10,6,1,18,8,0,43
11/26/2021,7,3,4,12,1,0,27
11/27/2021,18,8,9,15,6,1,57
11/28/2021,18,8,4,26,11,2,69
11/29/2021,20,4,2,28,4,4,62
11/30/2021,17,8,4,13,6,2,50
12/01/2021,13,9,1,12,3,0,38
12/02/2021,17,5,5,18,3,2,50
12/03/2021,14,2,8,13,7,2,46
12/04/2021,19,4,6,16,3,3,51
12/05/2021,9,12,4,12,4,0,41
12/06/2021,17,5,3,16,4,3,48
12/07/2021,7,10,4,16,5,1,43
12/08/2021,15,6,2,17,1,2,43
12/09/2021,15,4,3,20,6,4,52
12/10/2021,9,11,8,9,3,6,46
12/11/2021,15,8,9,12,3,0,47
12/12/2021,12,12,6,23,3,1,57
12/13/2021,21,8,3,13,7,1,53
12/14/2021,12,5,6,16,3,4,46
12/15/2021,14,9,2,19,4,3,51
12/16/2021,16,4,5,22,5,3,55
12/17/2021,20,3,5,12,6,6,52
12/18/2021,12,4,8,17,9,4,54
12/19/2021,18,10,3,12,1,5,49
12/20/2021,10,2,1,16,6,1,36
12/21/2021,11,3,3,11,4,2,34
12/22/2021,8,5,9,13,3,2,40
12/23/2021,15,3,3,18,4,1,44
12/24/2021,19,4,4,16,4,2,49
12/25/2021,15,5,9,17,6,3,55
12/26/2021,20,10,11,16,4,1,62
12/27/2021,8,8,3,14,5,4,42
12/28/2021,12,9,7,24,3,3,58
12/29/2021,14,4,7,16,2,5,48
12/30/2021,9,0,3,9,0,2,23
12/31/2021,6,0,0,10,2,1,19
01/01/2022,39,10,9,39,12,2,111
01/02/2022,16,4,8,22,5,3,58
01/03/2022,16,8,5,11,10,5,55
01/04/2022,20,1,6,10,9,5,51
01/05/2022,19,5,8,19,8,3,62
01/06/2022,13,5,1,13,8,2,42
01/07/2022,25,8,4,26,8,6,77
01/08/2022,15,7,7,19,6,3,57
01/09/2022,19,6,9,22,4,4,64
01/10/2022,19,3,4,16,9,3,54
01/11/2022,18,2,8,24,14,3,69
01/12/2022,18,5,4,22,5,1,55
01/13/2022,23,6,5,16,4,3,57
01/14/2022,16,5,5,16,11,7,60
01/15/2022,17,7,2,23,6,6,61
01/16/2022,13,6,6,25,4,1,55
01/17/2022,24,13,3,31,8,5,84
01/18/2022,31,6,4,25,13,3,82
01/19/2022,18,5,4,23,6,2,58
01/20/2022,21,9,4,20,11,3,68
01/21/2022,18,10,5,21,5,4,63
01/22/2022,16,11,10,16,7,4,64
01/23/2022,11,5,3,13,7,2,41
01/24/2022,23,8,4,21,4,3,63
01/25/2022,8,1,6,19,9,6,49
01/26/2022,15,0,0,18,6,2,41
01/27/2022,9,4,6,22,7,10,58
01/28/2022,11,6,8,15,6,3,49
01/29/2022,16,2,6,26,10,4,64
01/30/2022,15,4,9,21,6,2,57
01/31/2022,15,8,15,27,4,5,74
02/01/2022,23,12,3,21,8,4,71
02/02/2022,21,6,6,19,5,3,60
02/03/2022,26,13,7,23,9,4,82
02/04/2022,16,8,5,16,7,0,52
02/05/2022,16,3,5,12,8,2,46
02/06/2022,18,4,4,19,6,3,54
02/07/2022,13,8,6,8,12,0,47
02/08/2022,12,7,5,15,11,2,52
02/09/2022,16,3,6,21,8,2,56
02/10/2022,14,5,9,26,6,2,62
02/11/2022,14,3,11,16,8,2,54
02/12/2022,19,8,9,21,5,2,64
02/13/2022,11,3,10,21,7,1,53
02/14/2022,9,3,3,18,7,8,48
02/15/2022,21,9,7,18,7,7,69
02/16/2022,16,3,8,15,6,1,49
02/17/2022,10,4,4,15,5,4,42
02/18/2022,12,3,5,21,5,7,53
02/19/2022,19,7,8,14,5,0,53
02/20/2022,19,9,5,20,7,3,63
02/21/2022,12,5,4,7,11,3,42
02/22/2022,10,4,5,15,3,3,40
02/23/2022,19,3,5,18,6,4,55
02/24/2022,12,5,7,15,6,2,47
02/25/2022,14,4,7,16,3,4,48
02/26/2022,17,5,8,18,9,1,58
02/27/2022,21,8,3,14,4,6,56
02/28/2022,21,5,4,16,7,4,57
03/01/2022,21,6,8,17,5,6,63
03/02/2022,11,1,8,19,2,1,42
03/03/2022,7,5,10,17,10,1,50
03/04/2022,16,4,3,11,8,1,43
03/05/2022,19,8,6,21,5,4,63
03/06/2022,32,3,7,22,9,1,74
03/07/2022,9,7,9,27,9,4,65
03/08/2022,20,6,4,16,12,2,60
03/09/2022,15,9,8,19,1,6,58
03/10/2022,20,7,9,12,6,2,56
03/11/2022,14,7,6,17,10,3,57
03/12/2022,22,8,9,31,6,0,76
03/13/2022,16,3,8,19,3,2,51
03/14/2022,19,7,6,27,6,4,69
03/15/2022,18,4,4,19,7,4,56
03/16/2022,20,8,3,18,8,4,61
03/17/2022,18,4,1,17,6,2,48
03/18/2022,13,3,8,19,7,3,53
03/19/2022,16,9,1,15,7,4,52
03/20/2022,17,9,7,15,1,2,51
03/21/2022,24,2,5,21,5,2,59
03/22/2022,19,1,8,16,8,5,57
03/23/2022,13,5,12,13,10,1,54
03/24/2022,22,5,6,12,4,6,55
03/25/2022,13,6,6,12,4,1,42
03/26/2022,13,10,7,15,8,7,60
03/27/2022,22,8,3,21,2,4,60
03/28/2022,12,4,5,15,8,5,49
03/29/2022,13,2,4,15,11,3,48
03/30/2022,15,7,4,18,3,2,49
03/31/2022,17,4,7,10,6,6,50
04/01/2022,15,8,3,15,6,5,52
04/02/2022,22,6,5,21,6,2,62
04/03/2022,28,3,2,18,9,8,68
04/04/2022,22,5,6,21,6,2,62
04/05/2022,15,11,6,29,3,5,69
04/06/2022,13,11,6,15,1,1,47
04/07/2022,21,4,8,18,3,5,59
04/08/2022,21,10,4,23,4,4,66
04/09/2022,23,5,9,9,11,2,59
04/10/2022,14,3,5,26,4,4,56
04/11/2022,18,7,7,14,8,6,60
04/12/2022,23,8,6,26,8,4,75
04/13/2022,24,8,11,31,5,3,82
04/14/2022,17,5,15,26,8,2,73
04/15/2022,20,11,11,24,2,3,71
04/16/2022,22,8,7,23,6,4,70
04/17/2022,14,4,3,18,9,4,52
04/18/2022,16,5,10,15,8,4,58
04/19/2022,18,9,9,5,3,0,44
04/20/2022,10,3,2,10,10,4,39
04/21/2022,19,6,8,25,7,3,68
04/22/2022,9,8,2,11,7,3,40
04/23/2022,17,2,7,17,6,1,50
04/24/2022,14,5,2,3,9,3,36
04/25/2022,20,6,6,8,11,2,53
04/26/2022,9,7,7,18,4,4,49
04/27/2022,18,4,6,21,6,2,57
04/28/2022,17,7,4,14,8,4,54
04/29/2022,12,5,3,19,4,5,48
04/30/2022,16,9,7,18,4,6,60
05/01/2022,14,9,3,13,3,1,43
05/02/2022,17,11,4,15,5,5,57
05/03/2022,13,11,5,18,9,2,58
05/04/2022,16,5,10,12,6,0,49
05/05/2022,15,5,9,13,4,4,50
05/06/2022,11,12,6,20,7,2,58
05/07/2022,11,8,6,19,7,4,55
05/08/2022,17,12,6,12,7,0,54
05/09/2022,20,4,4,16,8,2,54
05/10/2022,13,7,3,23,5,5,56
05/11/2022,12,4,6,15,8,4,49
05/12/2022,24,5,5,19,14,2,69
05/13/2022,21,6,1,18,4,1,51
05/14/2022,20,10,3,16,10,2,61
05/15/2022,15,12,9,11,5,6,58
05/16/2022,16,4,10,9,6,5,50
05/17/2022,19,6,5,21,10,3,64
05/18/2022,11,7,9,11,7,3,48
05/19/2022,11,5,4,18,11,5,54
05/20/2022,10,8,3,7,7,0,35
05/21/2022,6,8,1,10,5,1,31
05/22/2022,12,9,5,12,5,3,46
05/23/2022,11,6,4,14,7,1,43
05/24/2022,13,10,2,10,5,2,42
05/25/2022,15,10,5,12,4,5,51
05/26/2022,12,4,7,10,7,3,43
05/27/2022,19,5,3,16,5,1,49
05/28/2022,12,8,4,15,6,4,49
05/29/2022,17,4,6,19,9,2,57
05/30/2022,17,9,5,20,6,5,62
05/31/2022,23,5,4,16,5,5,58
06/01/2022,14,5,8,10,13,3,53
06/02/2022,18,8,4,17,6,5,58
06/03/2022,18,6,5,17,9,3,58
06/04/2022,8,14,4,18,10,4,58
06/05/2022,18,7,4,20,14,1,64
06/06/2022,16,9,5,17,8,2,57
06/07/2022,6,4,8,19,4,2,43
06/08/2022,14,5,4,12,9,3,47
06/09/2022,5,8,8,15,7,1,44
06/10/2022,12,8,10,22,3,4,59
06/11/2022,13,6,9,21,7,6,62
06/12/2022,10,10,4,19,5,5,53
06/13/2022,12,6,10,15,10,1,54
06/14/2022,8,4,4,19,7,2,44
06/15/2022,8,9,3,14,3,4,41
06/16/2022,19,5,3,13,7,2,49
06/17/2022,18,4,5,15,9,3,54
06/18/2022,11,6,9,18,5,4,53
06/19/2022,11,1,4,10,6,1,33
06/20/2022,18,7,4,17,10,4,60
06/21/2022,11,5,8,11,5,4,44
06/22/2022,22,1,8,13,7,3,54
06/23/2022,16,1,5,13,6,0,41
06/24/2022,18,2,3,14,3,2,42
06/25/2022,14,10,4,13,9,0,50
06/26/2022,9,8,10,16,8,1,52
06/27/2022,18,5,5,10,7,4,49
06/28/2022,12,12,3,8,7,3,45
06/29/2022,13,5,5,12,4,7,46
06/30/2022,14,10,6,20,3,0,53
07/01/2022,12,3,3,18,11,2,49
07/02/2022,14,9,9,23,9,4,68
07/03/2022,22,3,4,21,7,3,60
07/04/2022,11,8,7,15,6,5,52
07/05/2022,13,2,6,12,7,0,40
07/06/2022,16,10,5,10,4,0,45
07/07/2022,12,9,9,12,1,4,47
07/08/2022,11,9,10,15,9,4,58
07/09/2022,21,3,9,14,12,0,59
07/10/2022,11,16,12,19,21,2,81
07/11/2022,12,4,8,18,12,3,57
07/12/2022,14,4,7,13,2,5,45
07/13/2022,16,5,3,13,7,10,54
07/14/2022,12,4,5,8,8,6,43
07/15/2022,11,1,1,9,9,2,33
07/16/2022,11,6,1,17,4,2,41
07/17/2022,14,7,9,16,10,1,57
07/18/2022,18,3,4,18,4,0,47
07/19/2022,10,7,7,6,7,2,39
07/20/2022,12,14,6,17,7,5,61
07/21/2022,17,4,1,17,6,2,47
07/22/2022,9,11,1,9,7,1,38
07/23/2022,8,9,2,12,10,3,44
07/24/2022,21,10,8,14,16,2,71
07/25/2022,13,3,7,10,10,4,47
07/26/2022,22,4,2,12,4,1,45
07/27/2022,11,5,2,14,10,3,45
07/28/2022,14,6,5,12,5,3,45
07/29/2022,11,5,4,9,3,5,37
07/30/2022,34,5,9,23,9,2,82
07/31/2022,18,7,5,13,5,1,49
08/01/2022,14,7,5,7,7,4,44
08/02/2022,15,3,6,8,7,3,42
08/03/2022,18,6,6,18,4,5,57
08/04/2022,16,9,4,12,3,3,47
08/05/2022,13,5,2,11,2,4,37
08/06/2022,13,5,6,12,7,4,47
08/07/2022,10,8,5,17,13,2,55
08/08/2022,9,10,4,8,7,1,39
08/09/2022,11,1,1,10,7,4,34
08/10/2022,21,5,6,15,1,2,50
08/11/2022,9,8,6,14,9,3,49
08/12/2022,7,3,5,7,11,4,37
08/13/2022,17,2,5,9,8,4,45
08/14/2022,12,4,4,10,2,2,34
08/15/2022,7,7,5,17,8,4,48
08/16/2022,22,4,5,20,7,0,58
08/17/2022,9,5,6,8,17,4,49
08/18/2022,16,6,3,8,2,2,37
08/19/2022,11,8,7,5,7,2,40
08/20/2022,17,2,6,15,8,6,54
08/21/2022,14,5,5,8,4,1,37
08/22/2022,14,4,5,17,6,1,47
08/23/2022,16,4,10,13,4,1,48
08/24/2022,8,6,5,16,6,2,43
08/25/2022,11,4,5,12,6,2,40
08/26/2022,9,5,4,10,8,1,37
08/27/2022,14,6,6,16,10,1,53
08/28/2022,18,5,12,15,5,1,56
08/29/2022,10,2,4,11,6,3,36
08/30/2022,10,5,7,16,11,2,51
08/31/2022,10,4,13,11,7,3,48
09/01/2022,12,4,8,16,9,4,53
09/02/2022,15,5,14,16,10,5,65
09/03/2022,19,1,11,17,4,1,53
09/04/2022,11,4,15,17,5,3,55
09/05/2022,10,10,3,12,8,3,46
09/06/2022,15,7,5,17,10,4,58
09/07/2022,7,4,5,6,12,6,40
09/08/2022,12,12,4,15,9,2,54
09/09/2022,11,7,5,11,10,1,45
09/10/2022,10,8,5,8,5,1,37
09/11/2022,9,7,5,20,7,1,49
09/12/2022,21,6,3,21,11,0,62
09/13/2022,13,9,7,11,7,0,47
09/14/2022,11,4,3,9,8,5,40
09/15/2022,8,4,3,13,7,4,39
09/16/2022,9,6,7,9,7,7,45
09/17/2022,9,5,6,10,10,5,45
09/18/2022,18,7,4,12,7,1,49
09/19/2022,14,6,7,12,6,0,45
09/20/2022,6,4,2,16,9,2,39
09/21/2022,13,11,2,16,7,2,51
09/22/2022,15,5,3,16,9,0,48
09/23/2022,11,3,1,12,7,2,36
09/24/2022,17,4,6,15,8,4,54
09/25/2022,11,8,6,15,6,5,51
09/26/2022,9,3,8,10,6,0,36
09/27/2022,23,5,4,2,2,3,39
09/28/2022,14,8,1,17,6,5,51
09/29/2022,9,1,4,9,4,1,28
09/30/2022,8,3,4,6,0,1,22
